UNITID,Year,INSTNM,State,Total_Students,Known_Students,Unknown_Students,In_State_Students,Out_State_Students,Foreign_Students,US_Students,Avg_Cost,Median_HH_Income
110653,2016,University of California-Irvine,CA,6551,6551,0,4860,149,1542,5009,34355,78085.65
110680,2016,University of California-San Diego,CA,5748,5746,2,4225,385,1136,4610,33240,76397.62
236948,2016,University of Washington-Seattle Campus,WA,6475,6463,12,4424,1084,955,5508,26825,69752.4
204796,2016,Ohio State University-Main Campus,OH,7938,7935,3,5289,1797,849,7086,27202,65208.79
110662,2016,University of California-Los Angeles,CA,6545,6542,3,4906,829,807,5735,35497,72896.84
110635,2016,University of California-Berkeley,CA,6252,6252,0,4729,867,656,5596,39016,77601.85
133951,2016,Florida International University,FL,4534,4502,32,3722,138,642,3860,19384,58110.89
240444,2016,University of Wisconsin-Madison,WI,6430,6426,4,3656,2231,539,5887,26393,71185.17
110705,2016,University of California-Santa Barbara,CA,4996,4994,2,4248,208,538,4456,36492,73046.19
123961,2016,University of Southern California,CA,3068,3058,10,1299,1293,466,2592,77362,76787.41
228778,2016,The University of Texas at Austin,TX,8719,8684,35,7651,581,452,8232,27397,72284.1
174066,2016,University of Minnesota-Twin Cities,MN,5880,5844,36,3783,1707,354,5490,27654,70741.62
134130,2016,University of Florida,FL,6833,6784,49,5678,758,348,6436,21151,60120.16
170976,2016,University of Michigan-Ann Arbor,MI,6689,6689,0,3402,2943,344,6345,30926,77145.9
122409,2016,San Diego State University,CA,5077,5077,0,4042,698,337,4740,23367,68953.33
137351,2016,University of South Florida-Main Campus,FL,4049,4018,31,3364,329,325,3693,21134,58397.57
131469,2016,George Washington University,DC,2525,2466,59,37,2111,318,2148,74023,85677.46
215062,2016,University of Pennsylvania,PA,2486,2418,68,442,1661,315,2103,78186,78252
209551,2016,University of Oregon,OR,4041,4037,4,1930,1801,306,3731,27717,62294.9
181464,2016,University of Nebraska-Lincoln,NE,4860,4796,64,3405,1085,306,4490,24400,60976.73
211440,2016,Carnegie Mellon University,PA,1552,1551,1,161,1089,301,1250,74489,81652.61
129020,2016,University of Connecticut,CT,3822,3822,0,2516,1006,300,3522,33896,80999.86
140951,2016,Savannah College of Art and Design,GA,2236,2205,31,340,1581,284,1921,58367,71588.69
108232,2016,Academy of Art University,CA,1064,1053,11,359,438,256,797,43976,74015.06
139755,2016,Georgia Institute of Technology-Main Campus,GA,2877,2853,24,1540,1059,254,2599,29291,77933.64
204024,2016,Miami University-Oxford,OH,3799,3796,3,2127,1420,249,3547,33805,72182.76
139658,2016,Emory University,GA,1358,1358,0,197,914,247,1111,72604,80509.92
217156,2016,Brown University,RI,1679,1679,0,64,1377,238,1441,77490,79027.35
132903,2016,University of Central Florida,FL,6388,6371,17,5659,483,229,6142,21309,62518.63
216339,2016,Temple University,PA,5162,5161,1,3576,1369,216,4945,33226,66650.68
199193,2016,North Carolina State University at Raleigh,NC,4388,4388,0,3677,496,215,4173,24202,64180.75
243744,2016,Stanford University,CA,1738,1738,0,608,917,213,1525,74570,80275.59
122612,2016,University of San Francisco,CA,1587,1580,7,978,391,211,1369,69987,82472.56
163453,2016,Morgan State University,MD,1141,1139,2,681,254,204,935,23254,63566.62
201645,2016,Case Western Reserve University,OH,1265,1264,1,307,759,198,1066,69526,69873.4
212054,2016,Drexel University,PA,2327,2299,28,966,1135,198,2101,69397,74533.27
130943,2016,University of Delaware,DE,4381,4380,1,1653,2533,194,4186,28708,84189.75
228796,2016,The University of Texas at El Paso,TX,3442,3442,0,3176,77,189,3253,18291,46777.52
130794,2016,Yale University,CT,1367,1367,0,83,1108,176,1191,76645,75345.96
110565,2016,California State University-Fullerton,CA,4426,4426,0,4200,51,175,4251,17791,73036.4
486840,2016,Kennesaw State University,GA,5347,5322,25,4258,895,169,5153,25059,64276.692131199976
198419,2016,Duke University,NC,1723,1663,60,207,1290,166,1497,77846,78468.48
137847,2016,The University of Tampa,FL,1907,1907,0,356,1386,165,1742,46341,71934.52
227216,2016,University of North Texas,TX,4850,4844,6,4492,188,164,4680,23770,72891.36
228769,2016,The University of Texas at Arlington,TX,3054,3054,0,2821,73,160,2894,23902,66876.51
225511,2016,University of Houston,TX,4463,4440,23,4169,112,159,4281,23361,68874.27
215293,2016,University of Pittsburgh-Pittsburgh Campus,PA,3954,3938,16,2456,1326,156,3782,33964,58452.18
131496,2016,Georgetown University,DC,1573,1573,0,20,1398,155,1418,76280,82187.36
199847,2016,Wake Forest University,NC,1306,1306,0,255,902,149,1157,74135,80539.14
201885,2016,University of Cincinnati-Main Campus,OH,5011,5008,3,4174,685,149,4859,26892,64722.83
206941,2016,University of Central Oklahoma,OK,2357,2357,0,2111,98,148,2209,24185,54764.86
152080,2016,University of Notre Dame,IN,2046,2046,0,113,1792,141,1905,74172,76710.92
163286,2016,University of Maryland-College Park,MD,5719,5667,52,3883,1644,140,5527,27343,90010.73
122755,2016,San Jose State University,CA,3208,3208,0,3027,42,139,3069,25747,88589.14
110583,2016,California State University-Long Beach,CA,4253,4253,0,4071,48,134,4119,19846,66954.9
217493,2016,Rhode Island School of Design,RI,456,447,9,18,295,134,313,72571,80568.35
221999,2016,Vanderbilt University,TN,1601,1597,4,133,1332,132,1465,73148,76279.78
134097,2016,Florida State University,FL,6190,6176,14,5290,755,131,6045,22278,60914.47
151111,2016,Indiana University-Purdue University-Indianapolis,IN,4003,3999,4,3698,174,127,3872,21127,64749.24
162928,2016,Johns Hopkins University,MD,1368,1336,32,114,1098,124,1212,74001,81539.46
227757,2016,Rice University,TX,978,978,0,417,438,123,855,67102,77707.58
228723,2016,Texas A & M University-College Station,TX,10145,10145,0,9515,508,122,10023,29920,67194.13
169080,2016,Calvin College,MI,929,929,0,473,336,120,809,50191,70660.49
230764,2016,University of Utah,UT,3601,3549,52,2481,949,119,3430,20303,69474.52
230038,2016,Brigham Young University-Provo,UT,5246,5099,147,1759,3221,119,4980,18936,64914.81
236939,2016,Washington State University,WA,4527,4494,33,3610,771,113,4381,26068,63710
228787,2016,The University of Texas at Dallas,TX,3229,3229,0,2988,130,111,3118,27120,79361.13
110370,2016,California College of the Arts,CA,256,256,0,86,60,110,146,68956,73343.27
117946,2016,Loyola Marymount University,CA,1331,1304,27,787,408,109,1195,70235,78631.93
207500,2016,University of Oklahoma-Norman Campus,OK,4198,4194,4,2439,1647,108,4086,29577,59522.71
110529,2016,California State Polytechnic University-Pomona,CA,4204,4204,0,4037,60,107,4097,22365,68064.96
122597,2016,San Francisco State University,CA,3642,3642,0,3514,23,105,3537,24513,77495.51
110608,2016,California State University-Northridge,CA,4499,4499,0,4342,52,105,4394,19794,64055.44
139940,2016,Georgia State University,GA,3935,3929,6,3449,376,104,3825,27206,72190.32
229115,2016,Texas Tech University,TX,4762,4760,2,4369,295,96,4664,23191,65284.89
228246,2016,Southern Methodist University,TX,1522,1515,7,585,834,96,1419,76346,82038.46
223232,2016,Baylor University,TX,3503,3496,7,2266,1137,93,3403,65222,73627.32
163295,2016,Maryland Institute College of Art,MD,351,351,0,57,203,91,260,66413,80395.11
204501,2016,Oberlin College,OH,762,760,2,52,618,90,670,77124,76190.1
207971,2016,University of Tulsa,OK,717,717,0,354,275,88,629,58637,62928.78
131520,2016,Howard University,DC,901,901,0,14,802,85,816,45971,66680.2
218663,2016,University of South Carolina-Columbia,SC,5110,5110,0,2391,2635,84,5026,28602,62188.24
206084,2016,University of Toledo,OH,3380,3373,7,2637,653,83,3290,25118,60626.38
227368,2016,The University of Texas Rio Grande Valley,TX,3944,3944,0,3844,17,83,3861,14250,35906.7
220978,2016,Middle Tennessee State University,TN,2893,2893,0,2567,244,82,2811,21241,60340.43
207388,2016,Oklahoma State University-Main Campus,OK,4156,4032,124,2622,1329,81,3951,23906,55237.91
109651,2016,Art Center College of Design,CA,211,211,0,111,20,80,131,66046,74131.88
110671,2016,University of California-Riverside,CA,5358,5357,1,5239,39,79,5278,30561,68292.12
211273,2016,Bryn Mawr College,PA,407,407,0,47,281,79,328,73540,78969.24
122931,2016,Santa Clara University,CA,1317,1317,0,735,504,78,1239,74297,93581.09
111948,2016,Chapman University,CA,1516,1515,1,929,510,76,1439,74336,73437.32
217235,2016,Johnson & Wales University-Providence,RI,2025,2021,4,299,1647,75,1946,51167,68856.12
121150,2016,Pepperdine University,CA,743,723,20,319,331,73,650,75312,79068.51
157085,2016,University of Kentucky,KY,5117,5112,5,3124,1915,73,5039,30178,59287.73
181394,2016,University of Nebraska at Omaha,NE,2065,2063,2,1795,195,73,1990,19797,66043.01
221759,2016,The University of Tennessee-Knoxville,TN,4851,4848,3,3980,796,72,4776,32010,60752.93
211291,2016,Bucknell University,PA,950,950,0,150,728,72,878,75400,84046.3
203517,2016,Kent State University at Kent,OH,4347,4341,6,3453,817,71,4270,25836,59479.84
150534,2016,University of Evansville,IN,537,535,2,290,175,70,465,50986,61532.75
131159,2016,American University,DC,1683,1652,31,19,1563,70,1582,66416,81657.17
150455,2016,Earlham College,IN,355,352,3,77,206,69,283,61156,66410.88
228875,2016,Texas Christian University,TX,1888,1881,7,819,993,69,1812,68072,76266.48
433660,2016,Florida Gulf Coast University,FL,2631,2624,7,2139,417,68,2556,18151,62394.85
182281,2016,University of Nevada-Las Vegas,NV,3859,3850,9,3116,667,67,3783,18756,70070.97
162283,2016,Coppin State University,MD,393,388,5,254,67,67,321,17787,54222.17
217165,2016,Bryant University,RI,843,843,0,92,684,67,776,62855,80219.8
202480,2016,University of Dayton,OH,1827,1827,0,773,987,67,1760,60900,75690.27
130590,2016,Trinity College,CT,572,572,0,76,430,66,506,76850,81265.21
157447,2016,Northern Kentucky University,KY,2147,2147,0,1497,584,66,2081,17869,63568.77
156365,2016,Campbellsville University,KY,598,598,0,448,86,64,534,38502,47586.61
139959,2016,University of Georgia,GA,5433,5433,0,4763,607,63,5370,27329,71225.06
215655,2016,Robert Morris University,PA,884,881,3,672,147,62,819,47724,59274.33
110574,2016,California State University-East Bay,CA,1596,1596,0,1525,9,62,1534,23357,78750.43
139931,2016,Georgia Southern University,GA,3600,3599,1,3371,167,61,3538,22608,62772.56
198969,2016,Methodist University,NC,485,485,0,270,156,59,426,55751,58239.21
159391,2016,Louisiana State University and Agricultural & Mechanical College,LA,5475,5467,8,4429,980,58,5409,32724,57504.74
112260,2016,Claremont McKenna College,CA,321,321,0,120,144,57,264,76475,82855.72
230959,2016,Middlebury College,VT,606,584,22,27,501,56,528,74248,77169.17
110592,2016,California State University-Los Angeles,CA,3830,3830,0,3760,14,56,3774,15307,52850.08
110556,2016,California State University-Fresno,CA,3302,3302,0,3212,34,56,3246,17683,53295.09
240453,2016,University of Wisconsin-Milwaukee,WI,3117,3116,1,2638,422,56,3060,21984,65921.14
135081,2016,Keiser University-Ft Lauderdale,FL,6901,6468,433,5366,1047,55,6413,40713,55699.66
163268,2016,University of Maryland-Baltimore County,MD,1538,1533,5,1386,92,55,1478,25997,83010.29
229027,2016,The University of Texas at San Antonio,TX,4377,4377,0,4223,99,55,4322,18923,63798.29
122436,2016,University of San Diego,CA,1133,1124,9,565,504,55,1069,70440,79883.39
172051,2016,Saginaw Valley State University,MI,1357,1357,0,1267,36,54,1303,22353,57827.75
239105,2016,Marquette University,WI,2005,2003,2,573,1377,53,1950,59725,75591.25
136950,2016,Rollins College,FL,538,538,0,283,204,51,487,66805,69363.5
240426,2016,University of Wisconsin-Superior,WI,376,376,0,154,172,50,326,18731,53835.5
482680,2016,University of North Georgia,GA,3959,3959,0,3791,120,48,3911,16816,64276.692131199976
110510,2016,California State University-San Bernardino,CA,2791,2791,0,2734,9,48,2743,19114,59070.9
188030,2016,New Mexico State University-Main Campus,NM,1842,1834,8,1398,389,47,1787,19760,43867.23
151290,2016,Indiana Institute of Technology,IN,1540,1530,10,855,629,46,1484,40161,60972.77
172644,2016,Wayne State University,MI,2588,2580,8,2492,42,46,2534,24541,61912.62
134945,2016,Jacksonville University,FL,551,549,2,312,191,46,503,54991,63671.93
120403,2016,Otis College of Art and Design,CA,203,198,5,115,37,46,152,66695,73811.67
187985,2016,University of New Mexico-Main Campus,NM,3402,3392,10,2835,511,46,3346,19351,49538.77
120254,2016,Occidental College,CA,502,500,2,194,261,45,455,76600,75275.66
163204,2016,University of Maryland-University College,MD,990,756,234,329,382,45,711,19764,73191.4
200800,2016,University of Akron Main Campus,OH,3090,3085,5,2727,314,44,3041,24604,58778.75
399911,2016,Soka University of America,CA,104,104,0,24,36,44,60,50968,79623.38
199139,2016,University of North Carolina at Charlotte,NC,3453,3452,1,3187,221,44,3408,23478,65762.02
183026,2016,Southern New Hampshire University,NH,4270,4192,78,585,3564,43,4149,50505,71986.54
366711,2016,California State University-San Marcos,CA,2152,2152,0,2066,43,43,2109,22531,72827.06
202134,2016,Cleveland State University,OH,1921,1921,0,1752,126,43,1878,24010,57782.89
181215,2016,University of Nebraska at Kearney,NE,1008,1008,0,883,83,42,966,23319,51335.53
129525,2016,University of Hartford,CT,1301,1301,0,520,739,42,1259,57475,82221.8
128744,2016,University of Bridgeport,CT,487,487,0,214,232,41,446,53853,63241.6
201441,2016,Bowling Green State University-Main Campus,OH,3545,3543,2,3086,416,41,3502,24529,63749.73
204857,2016,Ohio University-Main Campus,OH,4321,4321,0,3772,509,40,4281,29534,59563.35
102553,2016,University of Alaska Anchorage,AK,1825,1820,5,1705,75,40,1780,18946,72116.59
136172,2016,University of North Florida,FL,1978,1972,6,1860,72,40,1932,19469,62628.24
142285,2016,University of Idaho,ID,1660,1631,29,1193,398,40,1591,21525,54125.14
217484,2016,University of Rhode Island,RI,3256,3254,2,1417,1798,39,3215,30339,72503.8
132471,2016,Barry University,FL,480,475,5,229,208,38,437,47118,58621.88
209922,2016,Reed College,OR,354,354,0,22,294,38,316,75586,71777.6
220862,2016,University of Memphis,TN,2743,2743,0,2297,408,38,2705,24139,58823.6
154527,2016,Wartburg College,IA,445,445,0,271,137,37,408,55508,58222.9
163976,2016,St. John's College,MD,127,127,0,19,71,37,90,50001,72041.37
227845,2016,Saint Edward's University,TX,864,854,10,669,148,37,817,61707,71197.81
171571,2016,Oakland University,MI,2595,2595,0,2510,48,37,2558,23778,78696.54
141574,2016,University of Hawaii at Manoa,HI,1972,1969,3,1313,620,36,1933,23405,71646.27
169798,2016,Eastern Michigan University,MI,2801,2800,1,2350,414,36,2764,24994,69989
198516,2016,Elon University,NC,1553,1531,22,245,1250,36,1495,52587,81102.4
118541,2016,Marymount California University,CA,219,219,0,158,25,36,183,51791,73970.25
114354,2016,FIDM-Fashion Institute of Design & Merchandising-Los Angeles,CA,398,398,0,188,174,36,362,51281,73476
229063,2016,Texas Southern University,TX,1260,1260,0,1053,172,35,1225,23173,53781.71
181002,2016,Creighton University,NE,1033,1033,0,180,818,35,998,56120,68443.5
224147,2016,Texas A & M University-Corpus Christi,TX,2410,2410,0,2333,42,35,2375,22459,54287.8
117140,2016,University of La Verne,CA,557,556,1,497,24,35,521,60759,67082.29
230816,2016,Bennington College,VT,218,214,4,9,170,35,179,75972,77879.63
219000,2016,Augustana University,SD,424,424,0,180,210,34,390,47710,60196.68
209807,2016,Portland State University,OR,1691,1674,17,1102,538,34,1640,20571,62889.32
133650,2016,Florida Agricultural and Mechanical University,FL,1328,1324,4,1030,260,34,1290,23312,52786.24
198695,2016,High Point University,NC,1382,1375,7,285,1056,34,1341,54296,63207.13
213358,2016,La Roche College,PA,265,265,0,192,39,34,231,43073,61014.96
212106,2016,Duquesne University,PA,1556,1555,1,1057,465,33,1522,56199,61274.66
209056,2016,Lewis & Clark College,OR,506,505,1,56,417,32,473,68735,69786.29
482158,2016,Middle Georgia State University,GA,1327,1325,2,1185,108,32,1293,15822,64276.692131199976
142115,2016,Boise State University,ID,2628,2627,1,1484,1112,31,2596,21621,58298.66
130183,2016,Post University,CT,1433,1365,68,267,1067,31,1334,30161,67090.63
229267,2016,Trinity University,TX,662,662,0,500,131,31,631,60664,78650.29
203845,2016,Marietta College,OH,245,245,0,139,75,31,214,49601,58715.65
207582,2016,Oral Roberts University,OK,486,478,8,179,268,31,447,44006,63453.08
377555,2016,University of Washington-Bothell Campus,WA,820,818,2,771,17,30,788,23189,69752.4
150163,2016,Butler University,IN,1256,1245,11,522,693,30,1215,61623,71968.39
206622,2016,Xavier University,OH,1115,1115,0,472,614,29,1086,58260,68472.8
138600,2016,Agnes Scott College,GA,272,271,1,121,121,29,242,55403,69580.95
134237,2016,Full Sail University,FL,3601,3601,0,1228,2344,29,3572,35865,66113.73
107044,2016,Harding University,AR,1019,1019,0,287,703,29,990,31647,61757.88
128771,2016,Central Connecticut State University,CT,1269,1269,0,1143,98,28,1241,22518,75579.11
236595,2016,Seattle University,WA,985,974,11,301,645,28,946,63439,70785.55
141644,2016,Hawaii Pacific University,HI,462,458,4,127,303,28,430,47698,72804.49
174914,2016,University of St Thomas,MN,1349,1349,0,1002,319,28,1321,57785,76939.14
229160,2016,Texas Wesleyan University,TX,301,301,0,254,19,28,273,47135,62890.39
130226,2016,Quinnipiac University,CT,1910,1910,0,494,1388,28,1882,66237,87986.1
213251,2016,Juniata College,PA,394,394,0,230,136,28,366,61807,62290.9
107141,2016,John Brown University,AR,323,323,0,119,177,27,296,40774,56884.69
239318,2016,Milwaukee School of Engineering,WI,551,551,0,326,198,27,524,53885,68757.09
138293,2016,Webber International University,FL,178,177,1,135,15,27,150,42702,55372.47
226833,2016,Midwestern State University,TX,740,740,0,690,24,26,714,19972,57712.44
120883,2016,University of the Pacific,CA,726,714,12,633,55,26,688,64784,72621.06
157289,2016,University of Louisville,KY,2883,2882,1,2357,499,26,2856,28247,59042.66
240480,2016,University of Wisconsin-Stevens Point,WI,1591,1591,0,1382,183,26,1565,18217,62211.59
173300,2016,Concordia College at Moorhead,MN,545,541,4,363,152,26,515,53819,60523.09
129242,2016,Fairfield University,CT,1056,1056,0,281,750,25,1031,67080,93458.99
213996,2016,Messiah College,PA,685,682,3,425,232,25,657,49864,71914.01
237066,2016,Whitworth University,WA,595,595,0,360,210,25,570,60359,63739.65
156082,2016,Washburn University,KS,908,900,8,777,98,25,875,20011,57541.98
214175,2016,Muhlenberg College,PA,593,593,0,132,437,24,569,69413,89504.61
228149,2016,St. Mary's University,TX,587,586,1,512,50,24,562,42354,56236.53
122506,2016,San Francisco Conservatory of Music,CA,54,53,1,11,18,24,29,69135,74879.37
151777,2016,Manchester University,IN,389,389,0,325,40,24,365,45489,60877.57
117627,2016,La Sierra University,CA,327,326,1,272,30,24,302,45629,63313.83
170082,2016,Grand Valley State University,MI,4306,4306,0,3944,338,24,4282,24280,67198.25
217402,2016,Providence College,RI,1058,1058,0,90,944,24,1034,69407,83293.65
152530,2016,Taylor University,IN,472,472,0,184,264,24,448,48656,68822.46
182290,2016,University of Nevada-Reno,NV,3550,3541,9,2477,1040,24,3517,23256,68050.29
168740,2016,Andrews University,MI,304,304,0,73,208,23,281,40948,63096.48
414823,2016,Johnson & Wales University-North Miami,FL,472,472,0,230,219,23,449,37686.031269160027,68856.12
110617,2016,California State University-Sacramento,CA,3760,3760,0,3693,44,23,3737,21576,65686.13
204468,2016,Notre Dame College,OH,286,286,0,206,57,23,263,43425,60228.48
461795,2016,North American University,TX,95,95,0,60,12,23,72,20685,64276.692131199976
199698,2016,St Andrews University,NC,224,224,0,118,83,23,201,44686,64861.88
134079,2016,Florida Southern College,FL,648,648,0,393,232,23,625,52794,60789.21
240189,2016,University of Wisconsin-Whitewater,WI,2220,2220,0,1813,385,22,2198,18252,67955.05
221838,2016,Tennessee State University,TN,1307,1288,19,712,554,22,1266,22509,53809.87
225627,2016,University of the Incarnate Word,TX,788,788,0,737,29,22,766,45532,59715.43
218645,2016,University of South Carolina-Aiken,SC,623,619,4,529,68,22,597,20735,53123.12
169248,2016,Central Michigan University,MI,3519,3519,0,3206,291,22,3497,25078,66048.2
169716,2016,University of Detroit Mercy,MI,532,532,0,474,36,22,510,38440,64142.33
112075,2016,Concordia University-Irvine,CA,407,407,0,312,73,22,385,53235,79890.85
137476,2016,St Thomas University,FL,195,195,0,151,22,22,173,46539,56846.82
129941,2016,University of New Haven,CT,1128,1126,2,389,715,22,1104,58438,77310.15
110404,2016,California Institute of Technology,CA,235,228,7,55,151,22,206,74763,81448.64
151342,2016,Indiana University-South Bend,IN,913,913,0,872,19,22,891,16667,59249.25
215770,2016,Saint Joseph's University,PA,1274,1274,0,568,685,21,1253,63223,79940.44
214166,2016,Mount Aloysius College,PA,275,275,0,236,18,21,254,36886,45385.58
199962,2016,Wingate University,NC,625,625,0,480,124,21,604,49769,65044.99
137564,2016,Southeastern University,FL,1048,1024,24,578,425,21,1003,39276,60101.07
110538,2016,California State University-Chico,CA,2762,2762,0,2712,29,21,2741,25073,61867.44
125231,2016,Walden University,MN,186,186,0,1,165,20,166,37686.031269160027,62475.08
226587,2016,McMurry University,TX,284,283,1,252,11,20,263,41764,52571.87
200332,2016,North Dakota State University-Main Campus,ND,2503,2503,0,861,1622,20,2483,22201,55831.54
142294,2016,The College of Idaho,ID,238,238,0,137,81,20,218,45607,57741.96
133979,2016,Florida Memorial University,FL,384,384,0,296,68,20,364,28157,48349.61
136330,2016,Palm Beach Atlantic University,FL,505,505,0,273,212,20,485,49839,64221.06
160658,2016,University of Louisiana at Lafayette,LA,3024,3024,0,2877,128,19,3005,22948,47090.8
240462,2016,University of Wisconsin-Platteville,WI,1561,1561,0,1214,328,19,1542,18670,61602.16
156620,2016,Eastern Kentucky University,KY,2635,2635,0,2403,213,19,2616,23384,47617.36
199412,2016,Queens University of Charlotte,NC,279,279,0,138,123,18,261,49480,69597.25
240277,2016,University of Wisconsin-Green Bay,WI,872,872,0,779,75,18,854,17509,63413.11
221740,2016,The University of Tennessee-Chattanooga,TN,2077,2077,0,1984,75,18,2059,23436,55964.16
175856,2016,Jackson State University,MS,1292,1292,0,609,665,18,1274,24570,43401.54
215105,2016,The University of the Arts,PA,413,399,14,136,245,18,381,65881,75947.63
230807,2016,Westminster College,UT,434,434,0,217,199,18,416,49060,70649.66
159939,2016,University of New Orleans,LA,876,876,0,790,68,18,858,20864,51940.24
199148,2016,University of North Carolina at Greensboro,NC,2864,2862,2,2708,136,18,2844,19179,60658.11
111081,2016,California Institute of the Arts,CA,205,152,53,75,59,18,134,74111,74875.2
216597,2016,Villanova University,PA,1678,1678,0,283,1377,18,1660,73042,90091.77
236577,2016,Seattle Pacific University,WA,685,669,16,376,276,17,652,60834,72206.46
207847,2016,Southeastern Oklahoma State University,OK,516,516,0,341,158,17,499,16367,41386.98
217882,2016,Clemson University,SC,3684,3677,7,2282,1378,17,3660,32254,64586.36
213598,2016,Lincoln University,PA,526,525,1,220,288,17,508,26008,51404.66
169910,2016,Ferris State University,MI,1838,1822,16,1696,109,17,1805,23106,61040.62
223117,2016,Baptist Missionary Association Theological Seminary,TX,26,26,0,6,3,17,9,37686.031269160027,48842.7
202073,2016,Cleveland Institute of Music,OH,60,59,1,3,39,17,42,60680,78065.66
227881,2016,Sam Houston State University,TX,2758,2758,0,2687,54,17,2741,22885,63900.24
156213,2016,Asbury University,KY,306,306,0,155,134,17,289,42462,61842.48
110486,2016,California State University-Bakersfield,CA,1362,1362,0,1322,23,17,1345,18661,53982.7
131450,2016,Gallaudet University,DC,245,245,0,3,225,17,228,38892,65746.56
198950,2016,Meredith College,NC,423,423,0,377,29,17,406,50390,66301.42
215442,2016,Point Park University,PA,611,611,0,361,234,16,595,45350,54201.1
202170,2016,Columbus College of Art and Design,OH,240,237,3,173,48,16,221,49217,65843.21
199069,2016,University of Mount Olive,NC,293,283,10,219,48,16,267,32055,51727.18
228802,2016,The University of Texas at Tyler,TX,825,825,0,793,16,16,809,20730,53622.93
217819,2016,College of Charleston,SC,2349,2346,3,1374,956,16,2330,29545,66962.7
216667,2016,Washington & Jefferson College,PA,429,428,1,298,114,16,412,62814,61376.37
206437,2016,Walsh University,OH,440,440,0,362,62,16,424,42869,58552.19
221892,2016,Trevecca Nazarene University,TN,414,414,0,251,147,16,398,34473,59625.44
216038,2016,Slippery Rock University of Pennsylvania,PA,1564,1564,0,1357,191,16,1548,24600,54113.09
219976,2016,Lipscomb University,TN,637,635,2,371,248,16,619,49074,66979.13
141167,2016,Thomas University,GA,106,103,3,51,36,16,87,27354,45124.61
123952,2016,Southern California Institute of Architecture,CA,21,21,0,3,2,16,5,70734,66525.34
207324,2016,Oklahoma Christian University,OK,454,451,3,186,250,15,436,37015,63431.55
207856,2016,Southwestern Christian University,OK,162,162,0,111,36,15,147,28315,50467
222178,2016,Abilene Christian University,TX,1047,1046,1,951,80,15,1031,51577,67136.19
409698,2016,California State University-Monterey Bay,CA,802,802,0,757,30,15,787,23389,70802.17
123554,2016,Saint Mary's College of California,CA,562,562,0,473,74,15,547,69071,84232.87
213020,2016,Indiana University of Pennsylvania-Main Campus,PA,2306,2306,0,2178,113,15,2291,28442,54158.04
117557,2016,Lincoln University,CA,20,20,0,5,0,15,5,37686.031269160027,76284.11
153375,2016,Grand View University,IA,338,338,0,263,60,15,323,39864,62140.86
122454,2016,San Francisco Art Institute,CA,62,62,0,26,21,15,47,70023,72969.6
163338,2016,University of Maryland Eastern Shore,MD,715,714,1,524,175,15,699,24348,66039.83
152600,2016,Valparaiso University,IN,862,862,0,367,480,15,847,53847,72576.06
221731,2016,Tennessee Wesleyan University,TN,199,199,0,150,34,15,184,33219,48462.92
204936,2016,Otterbein University,OH,646,646,0,578,53,15,631,45773,67882
206604,2016,Wright State University-Main Campus,OH,2288,2288,0,2202,71,15,2273,23009,61970.64
220631,2016,Lincoln Memorial University,TN,305,299,6,197,87,15,284,36365,43510.38
197911,2016,Barton College,NC,241,241,0,174,52,15,226,46539,54814.93
180179,2016,Montana State University-Billings,MT,680,679,1,617,48,14,665,16755,48720.57
230834,2016,Castleton University,VT,476,476,0,315,147,14,462,24841,61392.97
140960,2016,Savannah State University,GA,1311,1309,2,1069,226,14,1295,16819,54220.88
227863,2016,University of St Thomas,TX,277,275,2,250,11,14,261,42652,71790.89
198561,2016,Gardner-Webb University,NC,444,444,0,304,126,14,430,45333,54757.84
226152,2016,Texas A & M International University,TX,1113,1113,0,1094,5,14,1099,13408,43910.56
213367,2016,La Salle University,PA,869,869,0,565,290,14,855,45298,67401.72
139764,2016,Georgia Southwestern State University,GA,485,485,0,445,26,14,471,19125,49591.36
209825,2016,University of Portland,OR,961,961,0,223,724,14,947,64049,67900.72
155335,2016,Newman University,KS,180,180,0,134,32,14,166,41633,62008.99
119775,2016,Newschool of Architecture and Design,CA,36,36,0,18,4,14,22,50284,67862.5
229018,2016,The University of Texas of the Permian Basin,TX,496,496,0,465,18,13,483,17323,47475.29
170037,2016,Cornerstone University,MI,283,283,0,223,47,13,270,35814,63718.46
239716,2016,Saint Norbert College,WI,584,584,0,460,111,13,571,51383,71321.9
204264,2016,Muskingum University,OH,319,319,0,286,20,13,306,41716,57566.05
130253,2016,Sacred Heart University,CT,1322,1321,1,355,953,13,1308,61591,87263.76
230995,2016,Norwich University,VT,799,795,4,77,705,13,782,59627,68974.52
207458,2016,Oklahoma City University,OK,329,324,5,137,174,13,311,44942,59190.63
141334,2016,University of West Georgia,GA,2434,2384,50,2357,14,13,2371,23684,66454.08
221351,2016,Rhodes College,TN,507,506,1,146,347,13,493,64249,73395.81
153269,2016,Drake University,IA,767,767,0,215,540,12,755,57643,70375.31
237118,2016,Alderson Broaddus University,WV,260,260,0,76,172,12,248,42676,44559.33
139366,2016,Columbus State University,GA,1055,1054,1,936,106,12,1042,19807,55979.92
181738,2016,Union College,NE,156,156,0,11,133,12,144,36243,60804.76
210429,2016,Western Oregon University,OR,899,898,1,669,217,12,886,22810,59410.15
238661,2016,Edgewood College,WI,263,262,1,225,25,12,250,44826,68115.77
151306,2016,University of Southern Indiana,IN,1681,1681,0,1437,232,12,1669,20146,57279.45
140447,2016,Mercer University,GA,856,856,0,703,141,12,844,52940,67164.94
198136,2016,Campbell University,NC,912,912,0,721,179,12,900,51131,56906.03
198899,2016,Mars Hill University,NC,396,396,0,286,98,12,384,45406,56558.51
449339,2016,American Public University System,WV,1340,1301,39,19,1270,12,1289,16569,64276.692131199976
229814,2016,West Texas A & M University,TX,1330,1330,0,1141,177,12,1318,20456,51385.91
150941,2016,Huntington University,IN,207,207,0,139,56,12,195,38461,63046.08
123165,2016,Scripps College,CA,270,259,11,109,138,12,247,77588,79153.99
217536,2016,Salve Regina University,RI,548,548,0,78,458,12,536,61072,81126.67
217721,2016,Benedict College,SC,604,601,3,350,239,12,589,28000,49336.04
174817,2016,Saint Mary's University of Minnesota,MN,283,283,0,138,133,12,271,49200,70833.22
110413,2016,California Lutheran University,CA,638,638,0,527,100,11,627,60668,81648.78
218742,2016,University of South Carolina-Upstate,SC,762,754,8,693,50,11,743,23660,54689.19
237899,2016,West Virginia State University,WV,420,420,0,300,109,11,409,19144,48790.55
173045,2016,Augsburg College,MN,477,477,0,398,68,11,466,54069,72224.74
139311,2016,Clayton  State University,GA,588,588,0,568,9,11,577,18374,65444.71
217518,2016,Roger Williams University,RI,1211,1207,4,143,1053,11,1196,54865,84094.11
231059,2016,Saint Michael's College,VT,461,461,0,66,384,11,450,61892,75427.87
155900,2016,Southwestern College,KS,182,182,0,55,116,11,171,46869,58156.66
218539,2016,Presbyterian College,SC,287,287,0,200,76,11,276,53720,62666.83
151801,2016,Indiana Wesleyan University-Marion,IN,684,684,0,380,294,10,674,39347,62930.13
214041,2016,Millersville University of Pennsylvania,PA,1327,1327,0,1197,120,10,1317,27526,65479.69
199643,2016,Shaw University,NC,643,643,0,412,221,10,633,29686,53196.27
235316,2016,Gonzaga University,WA,1271,1265,6,561,694,10,1255,61761,67848.44
482149,2016,Augusta University,GA,812,812,0,745,57,10,802,20115,64276.692131199976
199218,2016,University of North Carolina Wilmington,NC,2223,2222,1,1887,325,10,2212,24837,62176.12
217864,2016,Citadel Military College of South Carolina,SC,734,734,0,401,324,9,725,30022,66736.53
201654,2016,Cedarville University,OH,769,769,0,286,474,9,760,42318,67472.37
107512,2016,Ouachita Baptist University,AR,396,396,0,240,147,9,387,40200,61306.22
125763,2016,Whittier College,CA,426,423,3,329,85,9,414,61052,73825.46
207661,2016,Rogers State University,OK,668,665,3,640,16,9,656,20029,50487.79
216010,2016,Shippensburg University of Pennsylvania,PA,1381,1381,0,1269,103,9,1372,29182,63560.54
217907,2016,Coker College,SC,259,258,1,173,76,9,249,42395,49143.33
163046,2016,Loyola University Maryland,MD,1095,1091,4,167,915,9,1082,67196,92129.84
224323,2016,University of Dallas,TX,371,363,8,209,145,9,354,58050,75912.69
203368,2016,John Carroll University,OH,715,714,1,428,277,9,705,57651,68368.11
203580,2016,Lake Erie College,OH,219,219,0,148,62,9,210,45740,63624.4
218229,2016,Lander University,SC,608,608,0,563,36,9,599,24474,52256.85
154101,2016,Northwestern College,IA,282,282,0,131,142,9,273,45760,58600.59
198215,2016,Catawba College,NC,349,348,1,260,79,9,339,44235,60564.51
206048,2016,Tiffin University,OH,461,445,16,298,138,9,436,41055,59678.08
226091,2016,Lamar University,TX,1547,1547,0,1515,23,9,1538,20362,53474.77
219709,2016,Belmont University,TN,1571,1563,8,357,1197,9,1554,54595,70368.62
212197,2016,Elizabethtown College,PA,443,442,1,277,156,9,433,44978,70213.56
212160,2016,Edinboro University of Pennsylvania,PA,1034,1034,0,872,153,9,1025,22036,52799.06
117751,2016,The Master's University and Seminary,CA,174,174,0,103,62,9,165,40783,71662.94
152390,2016,Saint Mary's College,IN,432,432,0,119,304,9,423,58956,72879.94
202806,2016,Franklin University,OH,43,43,0,31,3,9,34,23956,59424.91
213349,2016,Kutztown University of Pennsylvania,PA,1693,1693,0,1440,245,8,1685,28414,67783.54
219949,2016,Cumberland University,TN,447,445,2,410,27,8,437,38392,59163.95
168528,2016,Adrian College,MI,490,462,28,352,102,8,454,54621,66915.1
225432,2016,University of Houston-Downtown,TX,939,936,3,925,3,8,928,20995,59551.33
169442,2016,College for Creative Studies,MI,269,269,0,218,43,8,261,57085,74293.04
240471,2016,University of Wisconsin-River Falls,WI,1219,1219,0,565,646,8,1211,17971,69159.98
212133,2016,Eastern University,PA,442,440,2,273,159,8,432,48828,68457.57
197869,2016,Appalachian State University,NC,3125,3121,4,2811,302,8,3113,19661,61267.04
240417,2016,University of Wisconsin-Stout,WI,1588,1588,0,978,602,8,1580,19704,65020.23
125897,2016,Woodbury University,CA,137,137,0,112,17,8,129,55032,60713.37
228468,2016,Southwestern Adventist University,TX,134,134,0,83,43,8,126,31865,57388.77
168786,2016,Aquinas College,MI,299,299,0,274,18,7,292,43921,64829.33
235097,2016,Eastern Washington University,WA,1697,1688,9,1574,107,7,1681,20480,56952.77
218070,2016,Furman University,SC,748,748,0,202,539,7,741,67299,71867.28
163462,2016,Mount St Mary's University,MD,417,415,2,210,198,7,408,57867,81781.05
175980,2016,Millsaps College,MS,252,252,0,95,150,7,245,57996,56763.17
202903,2016,Gods Bible School and College,OH,59,59,0,13,39,7,52,15632,53235.79
107071,2016,Henderson State University,AR,746,746,0,619,120,7,739,23005,45548.96
218654,2016,University of South Carolina-Beaufort,SC,487,484,3,397,80,7,477,24235,60345.78
214272,2016,Neumann University,PA,375,375,0,226,142,7,368,50640,69149.16
201548,2016,Capital University,OH,613,613,0,545,61,7,606,47719,64246.32
182458,2016,Sierra Nevada College,NV,94,94,0,20,67,7,87,50040,71252.07
228705,2016,Texas A & M University-Kingsville,TX,1257,1256,1,1241,8,7,1249,22645,45266.24
208822,2016,George Fox University,OR,635,609,26,283,319,7,602,51439,65616.22
228981,2016,Texas Lutheran University,TX,377,377,0,365,5,7,370,42208,65468.32
211893,2016,Curtis Institute of Music,PA,18,18,0,0,11,7,11,22192,70406
235167,2016,The Evergreen State College,WA,572,572,0,341,224,7,565,24371,63843.36
206349,2016,Ursuline College,OH,106,106,0,86,14,6,100,44600,60856.87
220215,2016,Freed-Hardeman University,TN,325,324,1,180,138,6,318,35099,53404.21
217934,2016,Columbia College,SC,146,146,0,123,17,6,140,33178,56463.66
210331,2016,Corban University,OR,239,237,2,103,128,6,231,45919,61069.68
204617,2016,Ohio Dominican University,OH,230,226,4,202,18,6,220,42524,65362.52
173160,2016,Bethel University,MN,565,558,7,439,113,6,552,52723,77038.37
162007,2016,Bowie State University,MD,967,965,2,889,70,6,959,22891,77046.6
211583,2016,Chestnut Hill College,PA,241,241,0,150,85,6,235,54599,61319.18
115728,2016,Holy Names University,CA,96,96,0,89,1,6,90,57486,72379.02
221661,2016,Southern Adventist University,TN,502,483,19,115,362,6,477,35820,60144.84
173328,2016,Concordia University-Saint Paul,MN,244,241,3,184,51,6,235,32686,71270.22
156286,2016,Bellarmine University,KY,637,637,0,458,173,6,631,56319,65601.28
139861,2016,Georgia College and State University,GA,1381,1381,0,1367,8,6,1375,28707,68382.02
212452,2016,Faith Theological Seminary,MD,13,13,0,7,0,6,7,37686.031269160027,64276.692131199976
210146,2016,Southern Oregon University,OR,699,661,38,306,349,6,655,17755,54749.32
236230,2016,Pacific Lutheran University,WA,680,616,64,415,195,6,610,56830,65366.76
217873,2016,Claflin University,SC,490,490,0,417,67,6,484,33777,45792.28
172264,2016,Siena Heights University,MI,293,293,0,254,34,5,288,39539,63208.96
220701,2016,Martin Methodist College,TN,262,262,0,212,45,5,257,40576,49230.32
181330,2016,Midland University,NE,341,341,0,212,124,5,336,45689,56723.06
240374,2016,University of Wisconsin-Parkside,WI,666,666,0,571,90,5,661,16320,64274.59
155627,2016,Ottawa University-Ottawa,KS,190,190,0,104,81,5,185,47369,65346.8
169479,2016,Davenport University,MI,632,623,9,589,29,5,618,31321,56679.53
229179,2016,Texas Woman's University,TX,1302,1278,24,1257,16,5,1273,19418,69739.2
207403,2016,Oklahoma Baptist University,OK,605,565,40,369,191,5,560,42983,59289.35
129534,2016,Holy Apostles College and Seminary,CT,16,16,0,3,8,5,11,37686.031269160027,64276.692131199976
225575,2016,Huston-Tillotson University,TX,145,145,0,125,15,5,140,24148,57117.25
219790,2016,Bryan College-Dayton,TN,208,208,0,157,46,5,203,38061,56756.79
141237,2016,Truett McConnell University,GA,222,222,0,198,19,5,217,33299,62186.38
180595,2016,Rocky Mountain College,MT,217,217,0,112,100,5,212,40804,51454.11
219082,2016,Dakota State University,SD,329,329,0,222,102,5,324,22365,52093.19
199032,2016,Montreat College,NC,165,165,0,96,64,5,160,40841,61225.9
215114,2016,Cairn University-Langhorne,PA,147,147,0,74,68,5,142,41762,69912.01
154712,2016,Benedictine College,KS,517,517,0,119,393,5,512,46309,64485.18
219383,2016,University of Sioux Falls,SD,281,281,0,135,141,5,276,30472,57493.05
121309,2016,Point Loma Nazarene University,CA,594,594,0,448,141,5,589,53045,71269.62
219833,2016,Christian Brothers University,TN,337,337,0,262,71,4,333,43939,61225.91
217305,2016,New England Institute of Technology,RI,444,444,0,225,215,4,440,45601,64106.73
155520,2016,MidAmerica Nazarene University,KS,180,180,0,81,95,4,176,48863,69737.68
161457,2016,University of New England,ME,722,722,0,167,551,4,718,56844,64934.4
204635,2016,Ohio Northern University,OH,598,598,0,461,133,4,594,49392,63536.16
199102,2016,North Carolina A & T State University,NC,1969,1967,2,1459,504,4,1963,18348,56398.61
236133,2016,Northwest University,WA,198,197,1,141,52,4,193,45095,71872.75
211088,2016,Arcadia University,PA,606,606,0,307,295,4,602,59684,72830.78
377564,2016,University of Washington-Tacoma Campus,WA,534,523,11,504,15,4,519,21705,69752.4
173665,2016,Hamline University,MN,548,548,0,445,99,4,544,51984,70958.04
198303,2016,Chowan University,NC,522,494,28,278,212,4,490,37161,53634.23
174127,2016,Minneapolis College of Art and Design,MN,163,159,4,75,80,4,155,53010,70094.27
215947,2016,Seton Hill University,PA,366,366,0,260,102,4,362,50395,54100.65
129215,2016,Eastern Connecticut State University,CT,1013,1013,0,889,120,4,1009,27425,76020.15
160755,2016,Tulane University of Louisiana,LA,1856,1781,75,230,1547,4,1777,75628,69803.28
238476,2016,Carthage College,WI,724,724,0,235,485,4,720,59175,76392.24
173452,2016,Martin Luther College,MN,196,196,0,28,164,4,192,27230,64939.16
160630,2016,Southern University at New Orleans,LA,145,145,0,132,9,4,141,16762,43920.92
110060,2016,Bethesda University,CA,89,38,51,32,3,3,35,22453,73410.31
159416,2016,Louisiana State University-Shreveport,LA,257,257,0,232,22,3,254,19065,47946.96
237367,2016,Fairmont State University,WV,816,802,14,699,100,3,799,17639,42179.08
216764,2016,West Chester University of Pennsylvania,PA,2454,2454,0,2075,376,3,2451,26114,74655.83
123572,2016,Sonoma State University,CA,1806,1806,0,1779,24,3,1803,26537,75511.05
228325,2016,Southwestern Assemblies of God University,TX,331,331,0,218,110,3,328,34268,59789.49
152099,2016,Oakland City University,IN,93,93,0,67,23,3,90,37683,52931.31
152567,2016,Trine University,IN,461,461,0,291,167,3,458,47142,60275.33
449870,2016,University of the West,CA,20,20,0,17,0,3,17,24236,64276.692131199976
151379,2016,Indiana University-Southeast,IN,935,935,0,729,203,3,932,17421,57669.69
159009,2016,Grambling State University,LA,865,856,9,490,363,3,853,24332,44602.47
158477,2016,Centenary College of Louisiana,LA,130,130,0,69,58,3,127,55300,58549.24
217688,2016,Charleston Southern University,SC,723,721,2,560,158,3,718,40177,57179.15
210401,2016,Willamette University,OR,474,474,0,101,370,3,471,66416,68135.42
141325,2016,Wesleyan College,GA,104,103,1,86,14,3,100,34952,57826.42
181446,2016,Nebraska Wesleyan University,NE,420,420,0,356,61,3,417,48718,59199.51
441937,2016,California State University-Channel Islands,CA,1010,1010,0,1005,2,3,1007,25150,78662.36
205124,2016,Rabbinical College Telshe,OH,14,14,0,6,5,3,11,20200,60972.72
151786,2016,Marian University,IN,392,392,0,324,65,3,389,49112,65206.92
180984,2016,Concordia University-Nebraska,NE,323,323,0,135,185,3,320,45672,60450.28
175005,2016,St Catherine University,MN,430,427,3,353,71,3,424,50794,71786.79
245953,2016,Mid-America Christian University,OK,135,135,0,104,28,3,132,28755,51555.64
204194,2016,Mount Vernon Nazarene University,OH,452,452,0,404,45,3,449,43341,60597.42
163578,2016,Notre Dame of Maryland University,MD,93,92,1,79,10,3,89,52667,70799.46
199184,2016,University of North Carolina School of the Arts,NC,213,213,0,100,110,3,210,21755,68862.71
201195,2016,Baldwin Wallace University,OH,706,706,0,523,180,3,703,48655,66257.54
181127,2016,Hastings College,NE,273,273,0,175,95,3,270,44893,58174.49
141185,2016,Toccoa Falls College,GA,215,215,0,154,58,3,212,37297,59357.86
140340,2016,Herzing University-Atlanta,GA,57,57,0,54,1,2,55,29587,57868.59
211024,2016,Clarks Summit University,PA,90,89,1,37,50,2,87,33826,62401.75
140234,2016,LaGrange College,GA,239,239,0,198,39,2,237,46034,61341.56
226383,2016,Lubbock Christian University,TX,320,320,0,275,43,2,318,37198,51468.15
198598,2016,Greensboro College,NC,249,249,0,196,51,2,247,30302,63893.94
176406,2016,Tougaloo College,MS,201,201,0,140,59,2,199,22784,44758.77
163532,2016,Ner Israel Rabbinical College,MD,35,35,0,19,14,2,33,23250,59120.36
110468,2016,Alliant International University-San Diego,CA,10,10,0,6,2,2,8,37686.031269160027,71211.32
180814,2016,Bellevue University,NE,34,34,0,20,12,2,32,22961,63424.91
203128,2016,Hiram College,OH,207,207,0,160,45,2,205,50555,63946.73
215691,2016,Rosemont College,PA,158,158,0,116,40,2,156,35805,57790.62
384412,2016,University of the Potomac-Washington DC Campus,DC,34,34,0,14,18,2,32,24964,78717.65
488068,2016,Huntington College of Health Sciences,TN,18,18,0,0,16,2,16,27091,64276.692131199976
199865,2016,Warren Wilson College,NC,185,184,1,58,124,2,182,52526,70885.71
201964,2016,Ohio Christian University,OH,653,653,0,310,341,2,651,32568,54881.86
170967,2016,Rochester College,MI,183,182,1,170,10,2,180,33013,72043.03
236328,2016,University of Puget Sound,WA,674,674,0,126,546,2,672,68072,72356.02
172033,2016,Sacred Heart Major Seminary,MI,18,17,1,15,0,2,15,36882,73787.59
133872,2016,Adventist University of Health Sciences,FL,92,92,0,79,11,2,90,33648,60028.37
131399,2016,University of the District of Columbia,DC,482,469,13,401,66,2,467,22638,51576.54
198756,2016,Johnson C Smith University,NC,302,301,1,163,136,2,299,33444,57295.75
137272,2016,Saint John Vianney College Seminary,FL,10,10,0,7,1,2,8,40000,64276.692131199976
142461,2016,Northwest Nazarene University,ID,225,225,0,113,110,2,223,42068,59470.41
209603,2016,Pacific Northwest College of Art,OR,81,81,0,28,51,2,79,54345,63108.93
217776,2016,Southern Wesleyan University,SC,203,202,1,149,51,2,200,35949,54696.17
212984,2016,Holy Family University,PA,328,328,0,284,42,2,326,37020,61868.46
199999,2016,Winston-Salem State University,NC,952,949,3,880,67,2,947,20382,54716.68
224004,2016,Concordia University-Texas,TX,280,280,0,269,9,2,278,47251,72128.5
157058,2016,Kentucky State University,KY,204,204,0,108,95,1,203,16885,51636.62
484905,2016,University of North Texas at Dallas,TX,280,279,1,277,1,1,278,18930,64276.692131199976
137953,2016,Trinity Baptist College,FL,97,95,2,70,24,1,94,22571,58249.91
219718,2016,Bethel University,TN,407,398,9,338,59,1,397,30992,50031.89
174437,2016,North Central University,MN,220,220,0,116,103,1,219,37644,65000.36
238193,2016,Alverno College,WI,168,168,0,150,17,1,167,40724,58784.16
213783,2016,Mansfield University of Pennsylvania,PA,450,450,0,355,94,1,449,24278,51271.33
214148,2016,Moore College of Art and Design,PA,71,70,1,39,30,1,69,60910,70661.87
238430,2016,Cardinal Stritch University,WI,165,165,0,141,23,1,164,44172,64348.07
117104,2016,Life Pacific College,CA,92,92,0,46,45,1,91,29158,65850.07
120184,2016,Notre Dame de Namur University,CA,157,154,3,134,19,1,153,37686.031269160027,89560.16
111188,2016,California State University Maritime Academy,CA,241,241,0,201,39,1,240,28149,78248.99
117575,2016,Southern California Seminary,CA,8,8,0,7,0,1,7,37686.031269160027,61547.27
238263,2016,Madison Area Technical College,WI,1765,1741,24,1715,25,1,1740,14210,64533.76
130493,2016,Southern Connecticut State University,CT,1400,1400,0,1332,67,1,1399,25413,74581.97
443599,2016,American College of Healthcare Sciences,OR,25,23,2,2,20,1,22,24887,64276.692131199976
227331,2016,Our Lady of the Lake University,TX,216,215,1,207,7,1,214,40753,52505.04
181783,2016,Wayne State College,NE,579,579,0,466,112,1,578,19521,51810.1
238616,2016,Concordia University-Wisconsin,WI,478,478,0,326,151,1,477,45936,64715.84
240338,2016,Wisconsin Lutheran College,WI,228,228,0,161,66,1,227,43118,69126.34
112084,2016,San Diego Christian College,CA,57,57,0,47,9,1,56,47755,66943.92
150604,2016,Franklin College,IN,238,238,0,223,14,1,237,46533,61682.88
217925,2016,Columbia International University,SC,81,81,0,42,38,1,80,36979,64434.93
152336,2016,University of Saint Francis-Fort Wayne,IN,343,343,0,298,44,1,342,40759,63802.5
136215,2016,Nova Southeastern University,FL,659,656,3,401,254,1,655,50429,62876.89
247773,2016,Yeshiva Gedolah of Greater Detroit,MI,13,13,0,9,3,1,12,15067,63218.7
216278,2016,Susquehanna University,PA,637,637,0,334,302,1,636,64760,72676.24
200004,2016,Western Carolina University,NC,1924,1924,0,1775,148,1,1923,18462,56230.92
202763,2016,The University of Findlay,OH,544,542,2,399,142,1,541,47032,61890.4
237792,2016,Shepherd University,WV,564,564,0,382,181,1,563,17759,62744.63
139719,2016,Fort Valley State University,GA,507,507,0,471,35,1,506,20264,53364.82
213613,2016,Lock Haven University,PA,828,828,0,778,49,1,827,25916,55815.84
209612,2016,Pacific University,OR,431,431,0,182,248,1,430,62157,64591.02
207157,2016,Randall University,OK,59,59,0,36,22,1,58,27838,51563.32
203085,2016,Heidelberg University,OH,372,371,1,301,69,1,370,44381,61648.4
213303,2016,Keystone College,PA,319,319,0,248,70,1,318,39200,51740.58
213400,2016,Lancaster Bible College,PA,178,178,0,102,75,1,177,36544,64787.49
210304,2016,Warner Pacific College,OR,98,98,0,72,25,1,97,32176,63798.34
128780,2016,Charter Oak State College,CT,15,15,0,9,5,1,14,16369,63157.4
220808,2016,Memphis College of Art,TN,77,77,0,50,26,1,76,37686.031269160027,64276.692131199976
162061,2016,Capitol Technology University,MD,95,95,0,65,29,1,94,40538,73053.75
169327,2016,Cleary University,MI,68,68,0,63,4,1,67,35998,81153.11
134510,2016,Hobe Sound Bible College,FL,49,48,1,11,36,1,47,14488,50360.1
199157,2016,North Carolina Central University,NC,1154,1150,4,916,233,1,1149,24075,57501.19
201371,2016,Bluffton University,OH,208,208,0,176,31,1,207,48205,59827.57
445708,2016,Johnson & Wales University-Charlotte,NC,655,653,2,238,414,1,652,50200,68856.12
224527,2016,East Texas Baptist University,TX,351,351,0,317,33,1,350,38749,56363.11
444778,2016,Charlotte Christian College and Theological Seminary,NC,5,5,0,4,0,1,4,37686.031269160027,62379.52
138868,2016,Point University,GA,321,321,0,186,134,1,320,34160,69033.68
202514,2016,Defiance College,OH,138,135,3,92,42,1,134,46420,61079.24
240392,2016,Herzing University-Madison,WI,144,144,0,36,107,1,143,29140,60281.46
216807,2016,Westminster College,PA,371,371,0,241,129,1,370,49932,56138.86
170000,2016,Grace Bible College,MI,140,130,10,76,53,1,129,22919,62527.83
225414,2016,University of Houston-Clear Lake,TX,266,266,0,266,0,0,266,25567,67975.01
438151,2016,Stevens-Henager College,UT,92,92,0,33,59,0,92,31726,60842.94
153162,2016,Cornell College,IA,287,262,25,50,212,0,262,58201,67428.42
198543,2016,Fayetteville State University,NC,647,647,0,617,30,0,647,16623,49808.38
486901,2016,Milligan College,TN,196,191,5,112,79,0,191,46072,64276.692131199976
438586,2016,American InterContinental University-Atlanta,GA,160,159,1,156,3,0,159,21048,58772.86
154350,2016,Simpson College,IA,348,348,0,251,97,0,348,53845,60274.33
221953,2016,Tusculum College,TN,325,309,16,153,156,0,309,39440,49705.55
156745,2016,Georgetown College,KY,297,296,1,225,71,0,296,53196,56937.11
216852,2016,Widener University,PA,738,738,0,426,312,0,738,62831,69397.52
480198,2016,Warner Pacific College Adult Degree Program,OR,11,11,0,8,3,0,11,21072,64276.692131199976
230056,2016,Broadview University-West Jordan,UT,23,23,0,20,3,0,23,27859,70004.7
161217,2016,University of Maine at Augusta,ME,307,307,0,301,6,0,307,16948,48750.5
225247,2016,Hardin-Simmons University,TX,393,384,9,372,12,0,384,42530,59593.97
456490,2016,Polytechnic University of Puerto Rico-Orlando,FL,6,5,1,5,0,0,5,22583,64276.692131199976
199607,2016,Salem College,NC,204,197,7,127,70,0,197,44461,59058
230366,2016,Eagle Gate College-Murray,UT,79,79,0,79,0,0,79,22097,64280.58
449038,2016,Strayer University-Florida,FL,82,82,0,74,8,0,82,28284,64276.692131199976
461281,2016,Jose Maria Vargas University,FL,1,1,0,1,0,0,1,37686.031269160027,64276.692131199976
477039,2016,West Coast University-Dallas,TX,3,3,0,3,0,0,3,27991,64276.692131199976
433536,2016,Herzing University-Kenner,LA,32,32,0,32,0,0,32,30319,57868.59
156471,2016,Galen College of Nursing-Louisville,KY,25,24,1,17,7,0,24,37686.031269160027,54499.36
209409,2016,Northwest Christian University,OR,81,81,0,52,29,0,81,43464,52696.79
459851,2016,Herzing University-Brookfield,WI,17,17,0,17,0,0,17,29268,64276.692131199976
128498,2016,Albertus Magnus College,CT,132,132,0,117,15,0,132,49375,65065.75
209287,2016,Multnomah University,OR,72,72,0,31,41,0,72,42743,65799
247162,2016,Ecumenical Theological Seminary,MI,6,6,0,6,0,0,6,37686.031269160027,64276.692131199976
408844,2016,Florida National University-Main Campus,FL,407,407,0,401,6,0,407,28378,51661.46
132879,2016,Johnson University Florida,FL,36,36,0,28,8,0,36,27611,59004.31
214971,2016,Pennsylvania Academy of the Fine Arts,PA,38,36,2,9,27,0,36,62147,70798.99
183062,2016,Keene State College,NH,1049,1046,3,375,671,0,1046,28880,75913.18
154022,2016,Ashford University,CA,731,731,0,42,689,0,731,25683,62011.29
201061,2016,Art Academy of Cincinnati,OH,55,55,0,36,19,0,55,44864,69050.69
444787,2016,Nightingale College,UT,17,17,0,17,0,0,17,37686.031269160027,60498.27
160065,2016,University of Holy Cross,LA,96,96,0,96,0,0,96,23715,52742.13
480985,2016,Midwives College of Utah,UT,2,2,0,0,2,0,2,24516,64276.692131199976
482565,2016,DeVry University-North Carolina,NC,5,5,0,3,2,0,5,37686.031269160027,64276.692131199976
203960,2016,Mercy College of Ohio,OH,62,62,0,46,16,0,62,22784,58075.98
433004,2016,American University of Health Sciences,CA,6,6,0,6,0,0,6,35965,58092.74
243823,2016,Parker University,TX,38,38,0,38,0,0,38,31420,69941.77
461148,2016,New York Film Academy,CA,180,40,140,40,0,0,40,54738,64276.692131199976
198507,2016,Elizabeth City State University,NC,203,202,1,187,15,0,202,12754,47337.89
203757,2016,Lourdes University,OH,213,207,6,135,72,0,207,37498,59351.8
133465,2016,South University-West Palm Beach,FL,25,25,0,25,0,0,25,28179,55764.27
214883,2016,Peirce College,PA,64,64,0,61,3,0,64,18260,49493.53
485546,2016,California Intercontinental University,CA,15,15,0,9,6,0,15,37686.031269160027,64276.692131199976
224776,2016,South University-The Art Institute of Dallas,TX,162,161,1,153,8,0,161,31913,69396.45
219639,2016,Baptist Memorial College of Health Sciences,TN,66,66,0,53,13,0,66,20485,61604.19
150677,2016,Grace College and Theological Seminary,IN,403,381,22,247,134,0,381,36725,63627.14
198613,2016,Guilford College,NC,428,427,1,255,172,0,427,53479,63141.25
484710,2016,University of Phoenix-Nevada,NV,2,2,0,2,0,0,2,37686.031269160027,64276.692131199976
449898,2016,South University-Tampa,FL,17,17,0,17,0,0,17,28397,64276.692131199976
442356,2016,Pennsylvania College of Health Sciences,PA,126,126,0,122,4,0,126,38003,63119.07
224554,2016,Texas A & M University-Commerce,TX,1004,997,7,981,16,0,997,22575,57562.14
215132,2016,University of the Sciences,PA,314,311,3,145,166,0,311,43968,72732.06
481058,2016,Grace Mission University,CA,8,6,2,6,0,0,6,18621,64276.692131199976
131283,2016,Catholic University of America,DC,723,718,5,16,702,0,718,65857,85196.61
459842,2016,Herzing University-Kenosha,WI,7,7,0,7,0,0,7,28529,64276.692131199976
118888,2016,Mills College,CA,169,167,2,127,40,0,167,48360,71756.45
214069,2016,Misericordia University,PA,430,430,0,269,161,0,430,48844,56588.57
139579,2016,South University-Savannah,GA,22,22,0,19,3,0,22,30800,55764.27
124487,2016,Epic Bible College,CA,10,8,2,0,8,0,8,37686.031269160027,63747.56
433420,2016,Santa Barbara Business College-Ventura,CA,27,27,0,27,0,0,27,42622,65732.08
206835,2016,Oklahoma Wesleyan University,OK,233,218,15,99,119,0,218,40883,51169.37
130314,2016,University of Saint Joseph,CT,126,126,0,117,9,0,126,50959,74607
216694,2016,Waynesburg University,PA,401,401,0,314,87,0,401,37431,52961.26
216357,2016,Thiel College,PA,277,277,0,149,128,0,277,48566,54604.75
217420,2016,Rhode Island College,RI,1170,1170,0,925,245,0,1170,17761,61569.63
475608,2016,Criswell College,TX,16,16,0,16,0,0,16,23142,64276.692131199976
114123,2016,Empire College,CA,189,189,0,189,0,0,189,37686.031269160027,70826.06
489779,2016,Kaplan University-Indianapolis,IN,21,21,0,20,1,0,21,37686.031269160027,64276.692131199976
174154,2016,Herzing University-Minneapolis,MN,33,33,0,32,1,0,33,28018,71504.15
440828,2016,Oregon State University-Cascades Campus,OR,55,55,0,54,1,0,55,25945,60312.67
106245,2016,University of Arkansas at Little Rock,AR,805,788,17,748,40,0,788,20416,51732.17
458955,2016,Strayer University-Mississippi,MS,20,20,0,20,0,0,20,37686.031269160027,64276.692131199976
457299,2016,Angeles College,CA,36,30,6,30,0,0,30,37686.031269160027,64276.692131199976
217624,2016,Allen University,SC,138,138,0,98,40,0,138,24695,49460.71
154688,2016,Baker University,KS,246,246,0,159,87,0,246,44473,67758.92
206279,2016,Union Institute & University,OH,13,13,0,2,11,0,13,31656,59714.64
181604,2016,College of Saint Mary,NE,103,103,0,72,31,0,103,31250,62625.82
204200,2016,Mount Saint Joseph University,OH,249,249,0,199,50,0,249,39248,64120.45
203465,2016,Kent State University at Stark,OH,747,747,0,744,3,0,747,12914,59479.84
443784,2016,Strayer University-Pennsylvania,PA,128,128,0,121,7,0,128,28284,64276.692131199976
168847,2016,Baker College,MI,2276,2276,0,2163,113,0,2276,19593,59405.88
475121,2016,South University–Savannah Online,GA,286,286,0,44,242,0,286,27732,64276.692131199976
159656,2016,Loyola University New Orleans,LA,615,603,12,224,379,0,603,54417,67759.61
160904,2016,Xavier University of Louisiana,LA,762,740,22,335,405,0,740,36391,55657.89
461032,2016,Carolina College of Biblical Studies,NC,10,10,0,10,0,0,10,21340,64276.692131199976
443049,2016,Faith International University,WA,31,31,0,31,0,0,31,20830,60716.89
454582,2016,Ottawa University-Online,KS,1,1,0,0,1,0,1,37686.031269160027,64276.692131199976
251312,2016,South University-Columbia,SC,22,22,0,21,1,0,22,28397,55764.27
461528,2016,Grace College of Divinity,NC,5,4,1,0,4,0,4,14977,64276.692131199976
484668,2016,University of Phoenix-Florida,FL,2,2,0,2,0,0,2,37686.031269160027,64276.692131199976
177038,2016,Cleveland University-Kansas City,KS,3,3,0,1,2,0,3,37686.031269160027,61070.83
205027,2016,Pontifical College Josephinum,OH,13,12,1,6,6,0,12,43542,56364.42
212656,2016,Geneva College,PA,292,290,2,195,95,0,290,38941,55668.91
110097,2016,Biola University,CA,872,858,14,650,208,0,858,58012,75484.4
378576,2016,Pacific College of Oriental Medicine-San Diego,CA,1,1,0,1,0,0,1,32037,64347.54
432223,2016,University of Phoenix-Washington,WA,2,2,0,2,0,0,2,37686.031269160027,64276.692131199976
484756,2016,University of Phoenix-Texas,TX,25,25,0,24,1,0,25,16367,64276.692131199976
234827,2016,Central Washington University,WA,1911,1908,3,1775,133,0,1908,24008,63170.67
175272,2016,Winona State University,MN,1575,1568,7,990,578,0,1568,22003,68678.3
199759,2016,Southeastern Baptist Theological Seminary,NC,32,31,1,26,5,0,31,18955,64276.692131199976
482459,2016,DeVry University-Florida,FL,32,32,0,30,2,0,32,37295,64276.692131199976
420042,2016,University of Phoenix-Hawaii,HI,3,3,0,3,0,0,3,18992,62086.89
225201,2016,Hallmark University,TX,66,66,0,66,0,0,66,37686.031269160027,55040.41
482431,2016,DeVry University-California,CA,111,107,4,106,1,0,107,35697,64276.692131199976
451103,2016,Miami Regional University,FL,187,187,0,187,0,0,187,37686.031269160027,64276.692131199976
199281,2016,University of North Carolina at Pembroke,NC,1091,1090,1,1078,12,0,1090,15952,49520.51
155681,2016,Pittsburg State University,KS,1012,1006,6,611,395,0,1006,18657,50242.27
422695,2016,Pacific College,CA,12,12,0,12,0,0,12,37686.031269160027,73126.5
442930,2016,University of Antelope Valley,CA,305,305,0,292,13,0,305,37686.031269160027,57306.38
131113,2016,Wilmington University,DE,682,682,0,516,166,0,682,18524,66924.87
482486,2016,DeVry University-Indiana,IN,1,1,0,1,0,0,1,24764,64276.692131199976
119605,2016,National University,CA,117,115,2,108,7,0,115,26208,64760.95
211477,2016,Central Penn College,PA,239,239,0,218,21,0,239,27042,56698.35
211556,2016,Chatham University,PA,194,191,3,148,43,0,191,52968,56097.18
176053,2016,Mississippi College,MS,574,574,0,339,235,0,574,34918,52824.92
447050,2016,United States University,CA,3,3,0,2,1,0,3,20187,63190.95
109785,2016,Azusa Pacific University,CA,1139,1116,23,890,226,0,1116,56802,73950.46
488448,2016,Seattle Film Institute,WA,7,7,0,6,1,0,7,46181,64276.692131199976
204006,2016,Miami University-Hamilton,OH,615,615,0,600,15,0,615,16237,72182.76
217059,2016,York College Pennsylvania,PA,903,902,1,516,386,0,902,32801,73378.65
134811,2016,AI Miami International University of Art and Design,FL,207,198,9,186,12,0,198,27974,57565.03
446561,2016,Stanbridge College,CA,164,164,0,164,0,0,164,37686.031269160027,90341.71
204176,2016,Mount Carmel College of Nursing,OH,112,111,1,110,1,0,111,21615,68565.22
135364,2016,Luther Rice College & Seminary,GA,17,17,0,9,8,0,17,37686.031269160027,65125.89
225399,2016,Houston Baptist University,TX,577,570,7,552,18,0,570,43638,72476.33
212832,2016,Gwynedd Mercy University,PA,225,225,0,198,27,0,225,47646,72929.99
201104,2016,Ashland University,OH,623,606,17,562,44,0,606,33775,64491.65
141486,2016,Chaminade University of Honolulu,HI,289,286,3,182,104,0,286,38649,72476.63
112394,2016,Cogswell College,CA,116,116,0,110,6,0,116,32382,90231.08
102669,2016,Alaska Pacific University,AK,40,39,1,24,15,0,39,34350,70542.98
239390,2016,Mount Mary University,WI,118,118,0,95,23,0,118,44284,62361.14
482468,2016,DeVry University-Georgia,GA,37,36,1,32,4,0,36,34215,64276.692131199976
460349,2016,Johnson & Wales University-Online,RI,17,17,0,2,15,0,17,25224,64276.692131199976
111966,2016,Charles R Drew University of Medicine and Science,CA,1,1,0,1,0,0,1,33171,55906.67
234915,2016,City University of Seattle,WA,17,17,0,14,3,0,17,37686.031269160027,67486.66
219046,2016,Black Hills State University,SD,587,582,5,383,199,0,582,20937,49477.45
485768,2016,Atlantis University,FL,84,73,11,65,8,0,73,24942,64276.692131199976
153320,2016,Faith Baptist Bible College and Theological Seminary,IA,74,61,13,24,37,0,61,28069,57604.15
445133,2016,American InterContinental University-Houston,TX,37,37,0,37,0,0,37,21745,58772.86
174020,2016,Metropolitan State University,MN,134,134,0,130,4,0,134,22819,69981.95
120537,2016,Hope International University,CA,111,96,15,82,14,0,96,46231,71774.01
199971,2016,Carolina Christian College,NC,1,1,0,1,0,0,1,14600,48527.11
484677,2016,University of Phoenix-Georgia,GA,6,6,0,6,0,0,6,37686.031269160027,64276.692131199976
218238,2016,Limestone College,SC,404,374,30,262,112,0,374,42137,53494.1
380465,2016,University of Phoenix-Utah,UT,1,1,0,1,0,0,1,37686.031269160027,62086.89
113582,2016,Design Institute of San Diego,CA,5,4,1,3,1,0,4,42928,71383.01
203474,2016,Kent State University at Trumbull,OH,272,272,0,271,1,0,272,13328,59479.84
171881,2016,Kuyper College,MI,38,34,4,32,2,0,34,33168,68721.86
213774,2016,Manor College,PA,120,120,0,113,7,0,120,25964,60787.72
443766,2016,Strayer University-Tennessee,TN,165,165,0,137,28,0,165,28284,64276.692131199976
211468,2016,Cedar Crest College,PA,181,176,5,124,52,0,176,52279,66384.94
220181,2016,Fisk University,TN,124,123,1,31,92,0,123,37482,55965.03
180832,2016,Clarkson College,NE,32,32,0,24,8,0,32,24917,61065.74
151263,2016,University of Indianapolis,IN,1032,985,47,841,144,0,985,44681,63891.1
459994,2016,Strayer University-Global Region,DC,387,387,0,0,387,0,387,28284,64276.692131199976
117672,2016,Southern California University of Health Sciences,CA,2,2,0,2,0,0,2,37686.031269160027,64276.692131199976
161873,2016,University of Baltimore,MD,176,147,29,141,6,0,147,24521,65721.01
459727,2016,Touro University Worldwide,CA,34,34,0,15,19,0,34,27335,64276.692131199976
216047,2016,Saint Charles Borromeo Seminary-Overbrook,PA,17,17,0,15,2,0,17,41324,58077.31
239071,2016,Maranatha Baptist University,WI,204,200,4,44,156,0,200,27793,62743.18
155636,2016,Ottawa University-Kansas City,KS,3,3,0,3,0,0,3,37686.031269160027,65346.8
157100,2016,Kentucky Christian University,KY,153,152,1,74,78,0,152,34496,53919.37
174358,2016,Minnesota State University Moorhead,MN,870,858,12,602,256,0,858,22525,54641.42
181297,2016,Nebraska Methodist College of Nursing & Allied Health,NE,44,42,2,37,5,0,42,31690,66507.51
114813,2016,Fresno Pacific University,CA,213,213,0,205,8,0,213,43317,53503.12
486965,2016,Hussian College-Relativity Campus California,CA,78,56,22,23,33,0,56,61271,64276.692131199976
489937,2016,Piedmont International University,NC,29,28,1,19,9,0,28,22830,64276.692131199976
157809,2016,Thomas More College,KY,414,414,0,230,184,0,414,42003,64733.74
465812,2016,Independence University,UT,772,755,17,11,744,0,755,31805,64276.692131199976
180878,2016,Bryan College of Health Sciences,NE,58,58,0,55,3,0,58,30615,58151.07
413413,2016,Capella University,MN,82,80,2,2,78,0,80,21167,64334.8
160074,2016,Our Lady of the Lake College,LA,92,92,0,92,0,0,92,26751,54007.12
211352,2016,Cabrini University,PA,486,480,6,341,139,0,480,46293,77292.03
402776,2016,Southwest University of Visual Arts-Albuquerque,NM,9,9,0,9,0,0,9,37686.031269160027,64276.692131199976
447263,2016,AmeriTech College-Draper,UT,29,29,0,29,0,0,29,26144,62933.79
414878,2016,Trine University-Regional/Non-Traditional Campuses,IN,3,3,0,1,2,0,3,37686.031269160027,60275.33
130989,2016,Goldey-Beacom College,DE,164,164,0,146,18,0,164,39197,70369.91
156125,2016,Wichita State University,KS,1505,1408,97,1175,233,0,1408,20418,60078.99
482574,2016,DeVry University-Ohio,OH,67,67,0,67,0,0,67,34949,64276.692131199976
222831,2016,Angelo State University,TX,1584,1510,74,1487,23,0,1510,19810,49632.36
220552,2016,South College,TN,302,302,0,226,76,0,302,27758,48993.08
215798,2016,Saint Vincent College,PA,393,393,0,305,88,0,393,50140,54143.22
218733,2016,South Carolina State University,SC,628,628,0,517,111,0,628,30015,48129.81
458973,2016,Strayer University-Texas,TX,100,100,0,99,1,0,100,28284,64276.692131199976
200013,2016,Rasmussen College-North Dakota,ND,35,35,0,22,13,0,35,23022,52350.64
453163,2016,Strayer University-North Carolina,NC,279,279,0,259,20,0,279,37686.031269160027,64276.692131199976
123651,2016,Vanguard University of Southern California,CA,413,411,2,355,56,0,411,48086,75891.29
213011,2016,Immaculata University,PA,219,219,0,120,99,0,219,44036,74355.43
151102,2016,Indiana University-Purdue University-Fort Wayne,IN,1600,1575,25,1472,103,0,1575,19224,61940.3
262086,2016,Brandman University,CA,33,32,1,23,9,0,32,32504,73437.32
122834,2016,Santa Barbara Business College-Bakersfield,CA,39,39,0,39,0,0,39,20065,46373.44
169363,2016,Concordia University-Ann Arbor,MI,199,199,0,172,27,0,199,45348,70459.21
484729,2016,University of Phoenix-North Carolina,NC,4,4,0,4,0,0,4,37686.031269160027,64276.692131199976
482608,2016,DeVry University-Pennsylvania,PA,20,20,0,18,2,0,20,34602,64276.692131199976
210492,2016,Bryn Athyn College of the New Church,PA,70,70,0,55,15,0,70,36254,96737.95
224226,2016,Dallas Baptist University,TX,527,527,0,473,54,0,527,42855,71641.68
372073,2016,Fremont College,CA,19,19,0,19,0,0,19,37686.031269160027,62794.03
401223,2016,World Mission University,CA,7,7,0,5,2,0,7,22025,62541
140818,2016,Piedmont College,GA,274,274,0,239,35,0,274,40949,58219.12
211981,2016,Delaware Valley University,PA,451,451,0,236,215,0,451,56828,74767.83
159647,2016,Louisiana Tech University,LA,2018,2000,18,1667,333,0,2000,21927,46738.12
439701,2016,The King's University,TX,29,29,0,23,6,0,29,22284,68510.99
162210,2016,Washington Adventist University,MD,79,79,0,71,8,0,79,33721,69837.96
157757,2016,Spalding University,KY,168,168,0,139,29,0,168,38163,55916.29
154013,2016,Mount Mercy University,IA,241,227,14,175,52,0,227,48189,61693.27
157793,2016,Sullivan University,KY,288,243,45,141,102,0,243,28469,55475.64
482617,2016,DeVry University-Tennessee,TN,1,1,0,1,0,0,1,37460,64276.692131199976
209241,2016,Mount Angel Seminary,OR,2,2,0,0,2,0,2,39700,59323.69
183257,2016,Granite State College,NH,75,75,0,54,21,0,75,18834,59743.94
154174,2016,Palmer College of Chiropractic,IA,1,1,0,1,0,0,1,37686.031269160027,59646.88
480781,2016,California Miramar University,CA,11,11,0,11,0,0,11,20578,64276.692131199976
219602,2016,Austin Peay State University,TN,1963,1948,15,1834,114,0,1948,23931,52472.51
120838,2016,Pacific States University,CA,2,1,1,1,0,0,1,37686.031269160027,64276.692131199976
430184,2016,Strayer University-Maryland,MD,200,200,0,190,10,0,200,28284,64276.692131199976
110361,2016,California Baptist University,CA,1146,1111,35,998,113,0,1111,48731,66849.57
204185,2016,University of Mount Union,OH,642,637,5,487,150,0,637,44497,61044.98
457086,2016,Homestead Schools,CA,1,1,0,1,0,0,1,37686.031269160027,64276.692131199976
116846,2016,American Jewish University,CA,4,4,0,4,0,0,4,37686.031269160027,80280.56
457484,2016,Pacific Rim Christian University,HI,29,29,0,25,4,0,29,23131,64276.692131199976
206862,2016,Southern Nazarene University,OK,268,265,3,145,120,0,265,38327,57571.98
222877,2016,Arlington Baptist College,TX,25,25,0,23,2,0,25,25381,61756.37
449764,2016,Visible Music College,TN,28,25,3,5,20,0,25,32644,64276.692131199976
150172,2016,Calumet College of Saint Joseph,IN,113,112,1,91,21,0,112,26540,57573.54
174491,2016,University of Northwestern-St Paul,MN,423,421,2,314,107,0,421,43817,70065.41
219471,2016,University of South Dakota,SD,1281,1243,38,787,456,0,1243,23016,53799.09
481720,2016,South University-High Point,NC,13,13,0,13,0,0,13,37686.031269160027,64276.692131199976
131803,2016,Strayer University-District of Columbia,DC,75,75,0,34,41,0,75,37686.031269160027,66472.61
216542,2016,University of Valley Forge,PA,139,138,1,56,82,0,138,36036,63922.06
131876,2016,Trinity Washington University,DC,237,235,2,142,93,0,235,32710,60221.46
458210,2016,West Coast University-Orange County,CA,15,15,0,15,0,0,15,41865,64276.692131199976
450571,2016,Rasmussen College-Wisconsin,WI,57,57,0,56,1,0,57,23497,64276.692131199976
115773,2016,Humphreys University-Stockton and Modesto Campuses,CA,14,14,0,14,0,0,14,21249,54713.65
386472,2016,Herzing University-Winter Park,FL,16,16,0,16,0,0,16,30319,57868.59
474863,2016,Azusa Pacific University College,CA,39,38,1,26,12,0,38,26995,64276.692131199976
181020,2016,Doane University-Arts & Sciences,NE,303,299,4,221,78,0,299,50470,57123.16
175421,2016,Belhaven University,MS,241,235,6,91,144,0,235,35975,57705.44
482547,2016,DeVry University-Nevada,NV,3,3,0,3,0,0,3,34274,64276.692131199976
139153,2016,Beulah Heights University,GA,16,15,1,13,2,0,15,11650,63599.65
456621,2016,Strayer University-West Virginia,WV,24,24,0,19,5,0,24,37686.031269160027,64276.692131199976
205443,2016,Shawnee State University,OH,864,859,5,768,91,0,859,16327,43961.17
155812,2016,University of Saint Mary,KS,122,122,0,57,65,0,122,42175,62613.14
138947,2016,Clark Atlanta University,GA,999,989,10,279,710,0,989,39194,60451.55
206154,2016,Tri-State Bible College,OH,2,1,1,1,0,0,1,14768,44613.4
151810,2016,Martin University,IN,24,24,0,24,0,0,24,23393,51133.47
119173,2016,Mount Saint Mary's University,CA,572,572,0,551,21,0,572,57689,59943.9
215743,2016,Saint Francis University,PA,351,340,11,250,90,0,340,54101,55181.27
155089,2016,Friends University,KS,165,165,0,116,49,0,165,39879,60343.56
237330,2016,Concord University,WV,471,459,12,393,66,0,459,16824,41360.98
135610,2016,Trinity International University-Florida,FL,6,6,0,6,0,0,6,37686.031269160027,72368.27
441636,2016,American Institute of Alternative Medicine,OH,25,24,1,24,0,0,24,31136,58848.36
482635,2016,DeVry University-Texas,TX,31,31,0,31,0,0,31,33151,64276.692131199976
211431,2016,Carlow University,PA,218,218,0,204,14,0,218,44201,52873.76
428259,2016,Ottawa University-Milwaukee,WI,1,1,0,1,0,0,1,37686.031269160027,65346.8
405997,2016,University of Phoenix-New Mexico,NM,1,1,0,0,1,0,1,37686.031269160027,64276.692131199976
458919,2016,Strayer University-Georgia,GA,506,506,0,476,30,0,506,28284,64276.692131199976
487603,2016,Northwest University-College of Adult and Professional Studies,WA,83,83,0,46,37,0,83,29793,64276.692131199976
227526,2016,Prairie View A & M University,TX,1839,1830,9,1714,116,0,1830,25164,57579.55
458885,2016,Strayer University-Arkansas,AR,19,19,0,19,0,0,19,37686.031269160027,64276.692131199976
484631,2016,University of Phoenix-California,CA,54,54,0,54,0,0,54,18184,64276.692131199976
160621,2016,Southern University and A & M College,LA,1086,1022,64,880,142,0,1022,23592,45854.37
154235,2016,Saint Ambrose University,IA,454,443,11,131,312,0,443,46894,63314.56
188058,2016,Northern New Mexico College,NM,142,142,0,140,2,0,142,13960,43101.41
132408,2016,The Baptist College of Florida,FL,34,34,0,25,9,0,34,19926,50305.97
110653,2017,University of California-Irvine,CA,6545,6545,0,5185,135,1225,5320,34355,78085.65
110680,2017,University of California-San Diego,CA,5699,5696,3,4392,350,954,4742,33240,76397.62
110635,2017,University of California-Berkeley,CA,6379,6374,5,4428,1165,781,5593,39016,77601.85
110662,2017,University of California-Los Angeles,CA,6038,6037,1,4419,903,715,5322,35497,72896.84
204796,2017,Ohio State University-Main Campus,OH,7209,7208,1,4990,1654,564,6644,27202,65208.79
110705,2017,University of California-Santa Barbara,CA,4538,4536,2,3748,253,535,4001,36492,73046.19
240444,2017,University of Wisconsin-Madison,WI,6609,6606,3,3721,2358,527,6079,26393,71185.17
129020,2017,University of Connecticut,CT,3683,3678,5,2462,795,421,3257,33896,80999.86
174066,2017,University of Minnesota-Twin Cities,MN,6195,6148,47,3845,1928,375,5773,27654,70741.62
140951,2017,Savannah College of Art and Design,GA,2429,2395,34,367,1660,368,2027,58367,71588.69
122409,2017,San Diego State University,CA,5366,5366,0,4197,823,346,5020,23367,68953.33
228778,2017,The University of Texas at Austin,TX,8381,8346,35,7337,673,336,8010,27397,72284.1
215062,2017,University of Pennsylvania,PA,2449,2382,67,368,1678,336,2046,78186,78252
204024,2017,Miami University-Oxford,OH,3822,3816,6,2182,1323,311,3505,33805,72182.76
134130,2017,University of Florida,FL,6428,6381,47,5373,698,310,6071,21151,60120.16
211440,2017,Carnegie Mellon University,PA,1676,1675,1,179,1188,308,1367,74489,81652.61
170976,2017,University of Michigan-Ann Arbor,MI,6847,6847,0,3565,2987,295,6552,30926,77145.9
131469,2017,George Washington University,DC,2610,2560,50,19,2272,269,2291,74023,85677.46
181464,2017,University of Nebraska-Lincoln,NE,4905,4831,74,3453,1115,263,4568,24400,60976.73
209551,2017,University of Oregon,OR,3938,3935,3,1854,1821,260,3675,27717,62294.9
139658,2017,Emory University,GA,1388,1388,0,181,950,257,1131,72604,80509.92
217156,2017,Brown University,RI,1637,1631,6,57,1328,246,1385,77490,79027.35
130943,2017,University of Delaware,DE,4671,4665,6,1768,2661,236,4429,28708,84189.75
122612,2017,University of San Francisco,CA,1532,1523,9,897,415,211,1312,69987,82472.56
163286,2017,University of Maryland-College Park,MD,5216,5201,15,3613,1387,201,5000,27343,90010.73
201645,2017,Case Western Reserve University,OH,1309,1309,0,328,795,186,1123,69526,69873.4
130794,2017,Yale University,CT,1579,1578,1,109,1284,185,1393,76645,75345.96
228769,2017,The University of Texas at Arlington,TX,3368,3366,2,3129,64,173,3193,23902,66876.51
139755,2017,Georgia Institute of Technology-Main Campus,GA,2859,2846,13,1756,917,173,2673,29291,77933.64
215293,2017,University of Pittsburgh-Pittsburgh Campus,PA,4019,4006,13,2508,1328,170,3836,33964,58452.18
199193,2017,North Carolina State University at Raleigh,NC,4797,4790,7,4070,550,170,4620,24202,64180.75
131496,2017,Georgetown University,DC,1597,1595,2,26,1399,170,1425,76280,82187.36
201885,2017,University of Cincinnati-Main Campus,OH,5400,5389,11,4349,873,167,5222,26892,64722.83
230764,2017,University of Utah,UT,4119,3990,129,2604,1223,163,3827,20303,69474.52
152080,2017,University of Notre Dame,IN,2051,2051,0,131,1757,163,1888,74172,76710.92
108232,2017,Academy of Art University,CA,805,796,9,273,362,161,635,43976,74015.06
137351,2017,University of South Florida-Main Campus,FL,4165,4130,35,3652,319,159,3971,21134,58397.57
228796,2017,The University of Texas at El Paso,TX,3589,3589,0,3355,79,155,3434,18291,46777.52
199847,2017,Wake Forest University,NC,1349,1349,0,251,945,153,1196,74135,80539.14
227216,2017,University of North Texas,TX,4992,4971,21,4615,208,148,4823,23770,72891.36
217493,2017,Rhode Island School of Design,RI,451,451,0,21,283,147,304,72571,80568.35
163295,2017,Maryland Institute College of Art,MD,423,423,0,68,209,146,277,66413,80395.11
139940,2017,Georgia State University,GA,4252,4095,157,3460,490,145,3950,27206,72190.32
225511,2017,University of Houston,TX,4959,4947,12,4686,120,141,4806,23361,68874.27
221999,2017,Vanderbilt University,TN,1607,1601,6,162,1301,138,1463,73148,76279.78
122755,2017,San Jose State University,CA,4490,4490,0,4295,58,137,4353,25747,88589.14
216339,2017,Temple University,PA,5171,5169,2,3673,1360,136,5033,33226,66650.68
227757,2017,Rice University,TX,1046,1042,4,436,471,135,907,67102,77707.58
486840,2017,Kennesaw State University,GA,5237,5222,15,4273,815,134,5088,25059,64276.692131199976
110565,2017,California State University-Fullerton,CA,4437,4437,0,4282,29,126,4311,17791,73036.4
131520,2017,Howard University,DC,2079,2079,0,23,1930,126,1953,45971,66680.2
207500,2017,University of Oklahoma-Norman Campus,OK,4473,4468,5,2545,1800,123,4345,29577,59522.71
137847,2017,The University of Tampa,FL,2141,2135,6,400,1614,121,2014,46341,71934.52
151111,2017,Indiana University-Purdue University-Indianapolis,IN,4093,4092,1,3766,205,121,3971,21127,64749.24
228723,2017,Texas A & M University-College Station,TX,11639,11619,20,10987,523,109,11510,29920,67194.13
122597,2017,San Francisco State University,CA,4324,4324,0,4173,45,106,4218,24513,77495.51
228246,2017,Southern Methodist University,TX,1423,1409,14,498,807,104,1305,76346,82038.46
111948,2017,Chapman University,CA,1696,1690,6,1021,569,100,1590,74336,73437.32
110529,2017,California State Polytechnic University-Pomona,CA,3786,3786,0,3659,35,92,3694,22365,68064.96
229115,2017,Texas Tech University,TX,5883,5882,1,5476,314,92,5790,23191,65284.89
110583,2017,California State University-Long Beach,CA,4138,4138,0,4013,37,88,4050,19846,66954.9
228787,2017,The University of Texas at Dallas,TX,3177,3177,0,2934,156,87,3090,27120,79361.13
220862,2017,University of Memphis,TN,2669,2669,0,2232,350,87,2582,24139,58823.6
110671,2017,University of California-Riverside,CA,4596,4596,0,4476,33,87,4509,30561,68292.12
110608,2017,California State University-Northridge,CA,5227,5227,0,5073,68,86,5141,19794,64055.44
207971,2017,University of Tulsa,OK,743,743,0,364,293,86,657,58637,62928.78
211273,2017,Bryn Mawr College,PA,354,354,0,37,233,84,270,73540,78969.24
220978,2017,Middle Tennessee State University,TN,3016,3016,0,2658,277,81,2935,21241,60340.43
130590,2017,Trinity College,CT,580,580,0,71,430,79,501,76850,81265.21
207388,2017,Oklahoma State University-Main Campus,OK,4218,4207,11,2724,1406,77,4130,23906,55237.91
157085,2017,University of Kentucky,KY,4855,4851,4,3059,1717,75,4776,30178,59287.73
236939,2017,Washington State University,WA,4611,4571,40,3727,769,75,4496,26068,63710
229027,2017,The University of Texas at San Antonio,TX,5029,5029,0,4876,79,74,4955,18923,63798.29
182281,2017,University of Nevada-Las Vegas,NV,4140,4135,5,3383,679,73,4062,18756,70070.97
230959,2017,Middlebury College,VT,635,616,19,13,531,72,544,74248,77169.17
228875,2017,Texas Christian University,TX,1955,1955,0,844,1041,70,1885,68072,76266.48
181394,2017,University of Nebraska at Omaha,NE,2100,2098,2,1839,190,69,2029,19797,66043.01
206941,2017,University of Central Oklahoma,OK,2243,2196,47,2041,86,69,2127,24185,54764.86
203517,2017,Kent State University at Kent,OH,4292,4279,13,3443,768,68,4211,25836,59479.84
209922,2017,Reed College,OR,411,411,0,35,314,62,349,75586,71777.6
482680,2017,University of North Georgia,GA,3964,3964,0,3804,98,62,3902,16816,64276.692131199976
223232,2017,Baylor University,TX,3320,3314,6,2126,1127,61,3253,65222,73627.32
112260,2017,Claremont McKenna College,CA,352,352,0,152,139,61,291,76475,82855.72
102553,2017,University of Alaska Anchorage,AK,1877,1872,5,1727,84,61,1811,18946,72116.59
139959,2017,University of Georgia,GA,5826,5825,1,5065,700,60,5765,27329,71225.06
217165,2017,Bryant University,RI,892,892,0,87,746,59,833,62855,80219.8
216597,2017,Villanova University,PA,1724,1724,0,310,1355,59,1665,73042,90091.77
211291,2017,Bucknell University,PA,973,973,0,191,724,58,915,75400,84046.3
139931,2017,Georgia Southern University,GA,3508,3504,4,3281,168,55,3449,22608,62772.56
163268,2017,University of Maryland-Baltimore County,MD,1772,1761,11,1571,135,55,1706,25997,83010.29
202480,2017,University of Dayton,OH,2226,2226,0,1032,1140,54,2172,60900,75690.27
136950,2017,Rollins College,FL,530,530,0,297,180,53,477,66805,69363.5
142285,2017,University of Idaho,ID,1537,1509,28,1131,326,52,1457,21525,54125.14
159391,2017,Louisiana State University and Agricultural & Mechanical College,LA,4917,4916,1,4008,857,51,4865,32724,57504.74
218663,2017,University of South Carolina-Columbia,SC,5880,5859,21,2841,2968,50,5809,28602,62188.24
136172,2017,University of North Florida,FL,2293,2288,5,2160,79,49,2239,19469,62628.24
227368,2017,The University of Texas Rio Grande Valley,TX,4504,4504,0,4442,13,49,4455,14250,35906.7
187985,2017,University of New Mexico-Main Campus,NM,3219,3215,4,2723,443,49,3166,19351,49538.77
239105,2017,Marquette University,WI,2023,2022,1,566,1408,48,1974,59725,75591.25
188030,2017,New Mexico State University-Main Campus,NM,2042,2039,3,1425,567,47,1992,19760,43867.23
240426,2017,University of Wisconsin-Superior,WI,345,345,0,161,137,47,298,18731,53835.5
490133,2017,Westcliff University,CA,53,53,0,6,1,46,7,22466,64276.692131199976
169798,2017,Eastern Michigan University,MI,2811,2808,3,2350,412,46,2762,24994,69989
111081,2017,California Institute of the Arts,CA,213,213,0,87,80,46,167,74111,74875.2
169716,2017,University of Detroit Mercy,MI,550,550,0,470,34,46,504,38440,64142.33
156365,2017,Campbellsville University,KY,541,541,0,418,79,44,497,38502,47586.61
399911,2017,Soka University of America,CA,107,107,0,22,42,43,64,50968,79623.38
482158,2017,Middle Georgia State University,GA,1159,1153,6,966,145,42,1111,15822,64276.692131199976
110556,2017,California State University-Fresno,CA,3446,3446,0,3381,23,42,3404,17683,53295.09
240453,2017,University of Wisconsin-Milwaukee,WI,3233,3232,1,2746,444,42,3190,21984,65921.14
221759,2017,The University of Tennessee-Knoxville,TN,4895,4894,1,3888,964,42,4852,32010,60752.93
227845,2017,Saint Edward's University,TX,793,788,5,649,97,42,746,61707,71197.81
172644,2017,Wayne State University,MI,2653,2641,12,2553,46,42,2599,24541,61912.62
150455,2017,Earlham College,IN,287,287,0,65,181,41,246,61156,66410.88
141574,2017,University of Hawaii at Manoa,HI,1959,1956,3,1233,682,41,1915,23405,71646.27
122436,2017,University of San Diego,CA,1210,1200,10,627,532,41,1159,70440,79883.39
128744,2017,University of Bridgeport,CT,550,550,0,282,228,40,510,53853,63241.6
129525,2017,University of Hartford,CT,1334,1331,3,597,695,39,1292,57475,82221.8
170082,2017,Grand Valley State University,MI,4117,4116,1,3667,410,39,4077,24280,67198.25
114354,2017,FIDM-Fashion Institute of Design & Merchandising-Los Angeles,CA,372,372,0,182,152,38,334,51281,73476
215655,2017,Robert Morris University,PA,873,869,4,700,131,38,831,47724,59274.33
120254,2017,Occidental College,CA,564,564,0,240,286,38,526,76600,75275.66
134097,2017,Florida State University,FL,6437,6437,0,5641,759,37,6400,22278,60914.47
110592,2017,California State University-Los Angeles,CA,3556,3556,0,3494,26,36,3520,15307,52850.08
168740,2017,Andrews University,MI,280,280,0,75,169,36,244,40948,63096.48
129242,2017,Fairfield University,CT,994,994,0,231,728,35,959,67080,93458.99
229160,2017,Texas Wesleyan University,TX,306,306,0,257,15,34,272,47135,62890.39
141644,2017,Hawaii Pacific University,HI,500,496,4,129,333,34,462,47698,72804.49
181215,2017,University of Nebraska at Kearney,NE,904,902,2,824,44,34,868,23319,51335.53
201441,2017,Bowling Green State University-Main Campus,OH,3344,3342,2,2944,365,33,3309,24529,63749.73
174914,2017,University of St Thomas,MN,1498,1495,3,1151,312,32,1463,57785,76939.14
132903,2017,University of Central Florida,FL,6870,6847,23,6256,559,32,6815,21309,62518.63
222178,2017,Abilene Christian University,TX,972,972,0,865,76,31,941,51577,67136.19
110574,2017,California State University-East Bay,CA,1420,1420,0,1374,15,31,1389,23357,78750.43
171571,2017,Oakland University,MI,2456,2456,0,2381,44,31,2425,23778,78696.54
122931,2017,Santa Clara University,CA,1406,1406,0,782,593,31,1375,74297,93581.09
222831,2017,Angelo State University,TX,1575,1575,0,1528,17,30,1545,19810,49632.36
236595,2017,Seattle University,WA,957,949,8,304,615,30,919,63439,70785.55
163976,2017,St. John's College,MD,122,122,0,9,84,29,93,50001,72041.37
226833,2017,Midwestern State University,TX,821,821,0,767,25,29,792,19972,57712.44
228149,2017,St. Mary's University,TX,643,643,0,562,52,29,614,42354,56236.53
200800,2017,University of Akron Main Campus,OH,3440,3436,4,3106,301,29,3407,24604,58778.75
160658,2017,University of Louisiana at Lafayette,LA,2982,2982,0,2825,128,29,2953,22948,47090.8
225627,2017,University of the Incarnate Word,TX,808,806,2,757,20,29,777,45532,59715.43
203845,2017,Marietta College,OH,272,272,0,161,83,28,244,49601,58715.65
204857,2017,Ohio University-Main Campus,OH,4049,4049,0,3520,502,27,4022,29534,59563.35
154527,2017,Wartburg College,IA,451,450,1,277,146,27,423,55508,58222.9
110486,2017,California State University-Bakersfield,CA,1436,1436,0,1389,20,27,1409,18661,53982.7
206437,2017,Walsh University,OH,462,462,0,389,47,26,436,42869,58552.19
134945,2017,Jacksonville University,FL,576,571,5,314,231,26,545,54991,63671.93
133650,2017,Florida Agricultural and Mechanical University,FL,1684,1681,3,1408,247,26,1655,23312,52786.24
110361,2017,California Baptist University,CA,1412,1411,1,1240,145,26,1385,48731,66849.57
229063,2017,Texas Southern University,TX,1975,1975,0,1634,315,26,1949,23173,53781.71
214175,2017,Muhlenberg College,PA,564,564,0,140,398,26,538,69413,89504.61
213367,2017,La Salle University,PA,1052,1049,3,711,312,26,1023,45298,67401.72
110510,2017,California State University-San Bernardino,CA,2517,2517,0,2485,6,26,2491,19114,59070.9
212106,2017,Duquesne University,PA,1562,1560,2,1058,477,25,1535,56199,61274.66
159939,2017,University of New Orleans,LA,960,960,0,870,65,25,935,20864,51940.24
175856,2017,Jackson State University,MS,933,933,0,369,539,25,908,24570,43401.54
110538,2017,California State University-Chico,CA,2805,2805,0,2751,29,25,2780,25073,61867.44
198516,2017,Elon University,NC,1573,1554,19,256,1274,24,1530,52587,81102.4
199069,2017,University of Mount Olive,NC,329,329,0,261,44,24,305,32055,51727.18
217721,2017,Benedict College,SC,563,563,0,355,184,24,539,28000,49336.04
156082,2017,Washburn University,KS,901,888,13,781,83,24,864,20011,57541.98
142115,2017,Boise State University,ID,2789,2789,0,1511,1254,24,2765,21621,58298.66
219000,2017,Augustana University,SD,481,480,1,212,245,23,457,47710,60196.68
157289,2017,University of Louisville,KY,2796,2796,0,2224,549,23,2773,28247,59042.66
221740,2017,The University of Tennessee-Chattanooga,TN,2147,2147,0,2009,115,23,2124,23436,55964.16
150163,2017,Butler University,IN,1054,1054,0,453,578,23,1031,61623,71968.39
156213,2017,Asbury University,KY,323,323,0,175,126,22,301,42462,61842.48
217819,2017,College of Charleston,SC,1840,1837,3,1032,783,22,1815,29545,66962.7
218070,2017,Furman,SC,702,702,0,182,498,22,680,67299,71867.28
213020,2017,Indiana University of Pennsylvania-Main Campus,PA,2430,2430,0,2266,142,22,2408,28442,54158.04
221953,2017,Tusculum College,TN,337,332,5,181,129,22,310,39440,49705.55
168528,2017,Adrian College,MI,529,529,0,380,127,22,507,54621,66915.1
123952,2017,Southern California Institute of Architecture,CA,32,32,0,9,2,21,11,70734,66525.34
110617,2017,California State University-Sacramento,CA,3591,3591,0,3521,49,21,3570,21576,65686.13
237066,2017,Whitworth University,WA,505,505,0,324,160,21,484,60359,63739.65
226152,2017,Texas A & M International University,TX,1148,1148,0,1121,6,21,1127,13408,43910.56
151102,2017,Indiana University-Purdue University-Fort Wayne,IN,1562,1562,0,1439,103,20,1542,19224,61940.3
129941,2017,University of New Haven,CT,1449,1448,1,588,840,20,1428,58438,77310.15
138293,2017,Webber International University,FL,173,173,0,137,16,20,153,42702,55372.47
151306,2017,University of Southern Indiana,IN,1714,1713,1,1464,229,20,1693,20146,57279.45
217402,2017,Providence College,RI,1064,1064,0,88,956,20,1044,69407,83293.65
209807,2017,Portland State University,OR,1929,1910,19,1421,469,20,1890,20571,62889.32
213996,2017,Messiah College,PA,665,665,0,432,213,20,645,49864,71914.01
219949,2017,Cumberland University,TN,562,562,0,514,28,20,542,38392,59163.95
169910,2017,Ferris State University,MI,1829,1817,12,1703,95,19,1798,23106,61040.62
237330,2017,Concord University,WV,434,434,0,318,97,19,415,16824,41360.98
229018,2017,The University of Texas of the Permian Basin,TX,452,452,0,420,13,19,433,17323,47475.29
157447,2017,Northern Kentucky University,KY,2145,2145,0,1496,630,19,2126,17869,63568.77
110097,2017,Biola University,CA,891,891,0,641,231,19,872,58012,75484.4
213598,2017,Lincoln University,PA,664,664,0,255,390,19,645,26008,51404.66
239318,2017,Milwaukee School of Engineering,WI,515,515,0,301,195,19,496,53885,68757.09
182290,2017,University of Nevada-Reno,NV,3643,3642,1,2670,953,19,3623,23256,68050.29
229814,2017,West Texas A & M University,TX,1245,1245,0,1059,167,19,1226,20456,51385.91
128771,2017,Central Connecticut State University,CT,1433,1433,0,1354,60,19,1414,22518,75579.11
217484,2017,University of Rhode Island,RI,3171,3169,2,1384,1767,18,3151,30339,72503.8
137476,2017,St Thomas University,FL,232,232,0,198,16,18,214,46539,56846.82
198950,2017,Meredith College,NC,395,393,2,343,32,18,375,50390,66301.42
130253,2017,Sacred Heart University,CT,1387,1385,2,345,1022,18,1367,61591,87263.76
110404,2017,California Institute of Technology,CA,235,235,0,82,135,18,217,74763,81448.64
207661,2017,Rogers State University,OK,612,605,7,564,23,18,587,20029,50487.79
366711,2017,California State University-San Marcos,CA,2499,2499,0,2437,44,18,2481,22531,72827.06
219709,2017,Belmont University,TN,1568,1565,3,455,1092,18,1547,54595,70368.62
140960,2017,Savannah State University,GA,893,889,4,739,132,18,871,16819,54220.88
239716,2017,Saint Norbert College,WI,526,526,0,394,115,17,509,51383,71321.9
123165,2017,Scripps College,CA,327,324,3,136,171,17,307,77588,79153.99
200332,2017,North Dakota State University-Main Campus,ND,2633,2633,0,884,1732,17,2616,22201,55831.54
228802,2017,The University of Texas at Tyler,TX,716,716,0,687,12,17,699,20730,53622.93
137564,2017,Southeastern University,FL,1226,1225,1,583,626,16,1209,39276,60101.07
199139,2017,University of North Carolina at Charlotte,NC,3373,3336,37,3129,191,16,3320,23478,65762.02
240462,2017,University of Wisconsin-Platteville,WI,1426,1425,1,1081,328,16,1409,18670,61602.16
170037,2017,Cornerstone University,MI,287,287,0,216,55,16,271,35814,63718.46
141334,2017,University of West Georgia,GA,2240,2178,62,2158,4,16,2162,23684,66454.08
169442,2017,College for Creative Studies,MI,263,263,0,207,40,16,247,57085,74293.04
110413,2017,California Lutheran University,CA,585,585,0,489,80,16,569,60668,81648.78
123554,2017,Saint Mary's College of California,CA,646,644,2,529,99,16,628,69071,84232.87
106245,2017,University of Arkansas at Little Rock,AR,762,762,0,675,72,15,747,20416,51732.17
199148,2017,University of North Carolina at Greensboro,NC,2791,2752,39,2644,93,15,2737,19179,60658.11
153269,2017,Drake University,IA,758,757,1,209,533,15,742,57643,70375.31
152530,2017,Taylor University,IN,448,448,0,197,236,15,433,48656,68822.46
175980,2017,Millsaps College,MS,229,229,0,90,124,15,214,57996,56763.17
240374,2017,University of Wisconsin-Parkside,WI,709,709,0,613,81,15,694,16320,64274.59
163204,2017,University of Maryland-University College,MD,676,673,3,254,404,15,658,19764,73191.4
213358,2017,La Roche College,PA,227,227,0,186,27,14,213,43073,61014.96
139366,2017,Columbus State University,GA,1003,997,6,887,96,14,983,19807,55979.92
156620,2017,Eastern Kentucky University,KY,2574,2574,0,2319,241,14,2560,23384,47617.36
152600,2017,Valparaiso University,IN,807,806,1,339,453,14,792,53847,72576.06
215114,2017,Cairn University-Langhorne,PA,154,154,0,66,74,14,140,41762,69912.01
218539,2017,Presbyterian College,SC,276,276,0,190,72,14,262,53720,62666.83
206622,2017,Xavier University,OH,1239,1238,1,492,732,14,1224,58260,68472.8
139311,2017,Clayton  State University,GA,644,642,2,617,11,14,628,18374,65444.71
207324,2017,Oklahoma Christian University,OK,513,509,4,233,262,14,495,37015,63431.55
218645,2017,University of South Carolina-Aiken,SC,573,569,4,511,44,14,555,20735,53123.12
169248,2017,Central Michigan University,MI,3076,3076,0,2760,302,14,3062,25078,66048.2
218229,2017,Lander University,SC,765,765,0,716,35,14,751,24474,52256.85
199218,2017,University of North Carolina Wilmington,NC,2145,2137,8,1785,338,14,2123,24837,62176.12
197869,2017,Appalachian State University,NC,3306,3298,8,2964,321,13,3285,19661,61267.04
240480,2017,University of Wisconsin-Stevens Point,WI,1560,1560,0,1315,232,13,1547,18217,62211.59
482149,2017,Augusta University,GA,910,906,4,842,51,13,893,20115,64276.692131199976
230807,2017,Westminster College,UT,369,369,0,198,158,13,356,49060,70649.66
122506,2017,San Francisco Conservatory of Music,CA,61,61,0,16,32,13,48,69135,74879.37
217518,2017,Roger Williams University,RI,1135,1132,3,116,1004,12,1120,54865,84094.11
218742,2017,University of South Carolina-Upstate,SC,879,875,4,820,43,12,863,23660,54689.19
213349,2017,Kutztown University of Pennsylvania,PA,1605,1605,0,1375,218,12,1593,28414,67783.54
138600,2017,Agnes Scott College,GA,251,251,0,143,96,12,239,55403,69580.95
176053,2017,Mississippi College,MS,571,571,0,338,221,12,559,34918,52824.92
112075,2017,Concordia University-Irvine,CA,328,328,0,220,96,12,316,53235,79890.85
151342,2017,Indiana University-South Bend,IN,982,981,1,943,26,12,969,16667,59249.25
237899,2017,West Virginia State University,WV,394,394,0,304,78,12,382,19144,48790.55
217882,2017,Clemson University,SC,3649,3649,0,2133,1504,12,3637,32254,64586.36
236230,2017,Pacific Lutheran University,WA,619,617,2,449,156,12,605,56830,65366.76
160904,2017,Xavier University of Louisiana,LA,716,711,5,300,399,12,699,36391,55657.89
131399,2017,University of the District of Columbia,DC,526,521,5,439,70,12,509,22638,51576.54
197911,2017,Barton College,NC,198,198,0,136,51,11,187,46539,54814.93
201654,2017,Cedarville University,OH,872,872,0,341,520,11,861,42318,67472.37
237118,2017,Alderson Broaddus University,WV,309,309,0,91,207,11,298,42676,44559.33
173045,2017,Augsburg University,MN,436,436,0,375,51,10,426,54069,72224.74
215442,2017,Point Park University,PA,640,640,0,441,189,10,630,45350,54201.1
215947,2017,Seton Hill University,PA,424,424,0,313,101,10,414,50395,54100.65
180595,2017,Rocky Mountain College,MT,247,247,0,132,105,10,237,40804,51454.11
217536,2017,Salve Regina University,RI,590,590,0,65,515,10,580,61072,81126.67
154013,2017,Mount Mercy University,IA,239,238,1,188,40,10,228,48189,61693.27
240277,2017,University of Wisconsin-Green Bay,WI,975,975,0,887,79,9,966,17509,63413.11
219602,2017,Austin Peay State University,TN,1983,1952,31,1821,122,9,1943,23931,52472.51
214041,2017,Millersville University of Pennsylvania,PA,1351,1351,0,1212,130,9,1342,27526,65479.69
168786,2017,Aquinas College,MI,314,314,0,283,22,9,305,43921,64829.33
219833,2017,Christian Brothers University,TN,385,385,0,274,102,9,376,43939,61225.91
240189,2017,University of Wisconsin-Whitewater,WI,2014,2014,0,1673,332,9,2005,18252,67955.05
139764,2017,Georgia Southwestern State University,GA,451,451,0,423,20,8,443,19125,49591.36
217864,2017,Citadel Military College of South Carolina,SC,687,687,0,381,298,8,679,30022,66736.53
203580,2017,Lake Erie College,OH,219,219,0,122,89,8,211,45740,63624.4
225432,2017,University of Houston-Downtown,TX,967,964,3,954,2,8,956,20995,59551.33
207847,2017,Southeastern Oklahoma State University,OK,529,529,0,354,167,8,521,16367,41386.98
154235,2017,Saint Ambrose University,IA,550,550,0,126,416,8,542,46894,63314.56
237367,2017,Fairmont State University,WV,764,761,3,679,74,8,753,17639,42179.08
212197,2017,Elizabethtown College,PA,411,411,0,291,112,8,403,44978,70213.56
160630,2017,Southern University at New Orleans,LA,206,206,0,187,11,8,198,16762,43920.92
204635,2017,Ohio Northern University,OH,640,640,0,519,113,8,632,49392,63536.16
216038,2017,Slippery Rock University of Pennsylvania,PA,1598,1597,1,1433,157,7,1590,24600,54113.09
227863,2017,University of St Thomas,TX,295,295,0,287,1,7,288,42652,71790.89
156286,2017,Bellarmine University,KY,681,681,0,460,214,7,674,56319,65601.28
217873,2017,Claflin University,SC,519,519,0,453,59,7,512,33777,45792.28
234827,2017,Central Washington University,WA,2133,2111,22,1989,115,7,2104,24008,63170.67
221838,2017,Tennessee State University,TN,1497,1466,31,612,847,7,1459,22509,53809.87
228705,2017,Texas A & M University-Kingsville,TX,1114,1112,2,1099,6,7,1105,22645,45266.24
207458,2017,Oklahoma City University,OK,296,294,2,104,183,7,287,44942,59190.63
409698,2017,California State University-Monterey Bay,CA,926,926,0,895,24,7,919,23389,70802.17
122454,2017,San Francisco Art Institute,CA,53,51,2,18,26,7,44,70023,72969.6
155900,2017,Southwestern College,KS,189,189,0,68,115,6,183,46869,58156.66
154688,2017,Baker University,KS,258,258,0,191,61,6,252,44473,67758.92
131159,2017,American University,DC,1785,1704,81,22,1676,6,1698,66416,81657.17
152099,2017,Oakland City University,IN,99,99,0,70,23,6,93,37683,52931.31
236328,2017,University of Puget Sound,WA,593,591,2,125,460,6,585,68072,72356.02
208822,2017,George Fox University,OR,634,605,29,314,285,6,599,51439,65616.22
218654,2017,University of South Carolina-Beaufort,SC,487,485,2,419,60,6,479,24235,60345.78
131450,2017,Gallaudet University,DC,247,247,0,2,239,6,241,38892,65746.56
212160,2017,Edinboro University of Pennsylvania,PA,846,846,0,725,115,6,840,22036,52799.06
227526,2017,Prairie View A & M University,TX,2055,2055,0,1893,156,6,2049,25164,57579.55
154712,2017,Benedictine College,KS,438,438,0,95,337,6,432,46309,64485.18
121309,2017,Point Loma Nazarene University,CA,618,618,0,462,150,6,612,53045,71269.62
123572,2017,Sonoma State University,CA,1831,1830,1,1807,18,5,1825,26537,75511.05
225575,2017,Huston-Tillotson University,TX,183,183,0,169,9,5,178,24148,57117.25
155335,2017,Newman University,KS,212,212,0,169,38,5,207,41633,62008.99
217305,2017,New England Institute of Technology,RI,523,523,0,281,237,5,518,45601,64106.73
201548,2017,Capital University,OH,595,595,0,538,52,5,590,47719,64246.32
173452,2017,Martin Luther College,MN,183,183,0,23,155,5,178,27230,64939.16
180179,2017,Montana State University-Billings,MT,647,646,1,574,67,5,641,16755,48720.57
240417,2017,University of Wisconsin-Stout,WI,1528,1527,1,945,577,5,1522,19704,65020.23
112084,2017,San Diego Christian College,CA,71,69,2,55,9,5,64,47755,66943.92
139861,2017,Georgia College & State University,GA,1443,1440,3,1432,3,5,1435,28707,68382.02
213613,2017,Lock Haven University,PA,790,790,0,752,33,5,785,25916,55815.84
216010,2017,Shippensburg University of Pennsylvania,PA,1218,1218,0,1135,78,5,1213,29182,63560.54
198756,2017,Johnson C Smith University,NC,339,339,0,177,157,5,334,33444,57295.75
181330,2017,Midland University,NE,326,326,0,197,124,5,321,45689,56723.06
226587,2017,McMurry University,TX,246,246,0,228,13,5,241,41764,52571.87
221661,2017,Southern Adventist University,TN,567,546,21,124,417,5,541,35820,60144.84
173160,2017,Bethel University,MN,598,587,11,469,114,4,583,52723,77038.37
129534,2017,Holy Apostles College and Seminary,CT,14,14,0,2,8,4,10,37686.031269160027,64276.692131199976
129215,2017,Eastern Connecticut State University,CT,925,925,0,812,109,4,921,27425,76020.15
152336,2017,University of Saint Francis-Fort Wayne,IN,454,454,0,396,54,4,450,40759,63802.5
199184,2017,University of North Carolina School of the Arts,NC,173,172,1,80,88,4,168,21755,68862.71
152567,2017,Trine University,IN,602,602,0,348,250,4,598,47142,60275.33
237792,2017,Shepherd University,WV,598,598,0,413,181,4,594,17759,62744.63
486965,2017,Hussian College-Relativity Campus California,CA,86,84,2,16,64,4,80,61271,64276.692131199976
217776,2017,Southern Wesleyan University,SC,201,198,3,139,55,4,194,35949,54696.17
235167,2017,The Evergreen State College,WA,521,521,0,380,137,4,517,24371,63843.36
226383,2017,Lubbock Christian University,TX,310,310,0,272,35,3,307,37198,51468.15
214272,2017,Neumann University,PA,360,360,0,217,140,3,357,50640,69149.16
199102,2017,North Carolina A & T State University,NC,2309,2273,36,1625,645,3,2270,18348,56398.61
440828,2017,Oregon State University-Cascades Campus,OR,81,81,0,75,3,3,78,25945,60312.67
170967,2017,Rochester College,MI,165,165,0,153,9,3,162,33013,72043.03
240338,2017,Wisconsin Lutheran College,WI,233,233,0,161,69,3,230,43118,69126.34
151379,2017,Indiana University-Southeast,IN,927,927,0,692,232,3,924,17421,57669.69
217907,2017,Coker College,SC,210,210,0,132,75,3,207,42395,49143.33
206349,2017,Ursuline College,OH,79,79,0,68,8,3,76,44600,60856.87
218733,2017,South Carolina State University,SC,591,591,0,509,79,3,588,30015,48129.81
203085,2017,Heidelberg University,OH,319,319,0,246,70,3,316,44381,61648.4
181783,2017,Wayne State College,NE,606,606,0,498,105,3,603,19521,51810.1
212133,2017,Eastern University,PA,381,381,0,222,156,3,378,48828,68457.57
229179,2017,Texas Woman's University,TX,1280,1274,6,1254,17,3,1271,19418,69739.2
137953,2017,Trinity Baptist College,FL,63,63,0,46,14,3,60,22571,58249.91
216764,2017,West Chester University of Pennsylvania,PA,2630,2630,0,2273,355,2,2628,26114,74655.83
151786,2017,Marian University,IN,338,338,0,288,48,2,336,49112,65206.92
162210,2017,Washington Adventist University,MD,109,109,0,58,49,2,107,33721,69837.96
181020,2017,Doane University-Arts & Sciences,NE,299,299,0,227,70,2,297,50470,57123.16
217934,2017,Columbia College,SC,160,159,1,143,14,2,157,33178,56463.66
210492,2017,Bryn Athyn College of the New Church,PA,97,94,3,62,30,2,92,36254,96737.95
157757,2017,Spalding University,KY,171,171,0,138,31,2,169,38163,55916.29
209612,2017,Pacific University,OR,424,424,0,158,264,2,422,62157,64591.02
201195,2017,Baldwin Wallace University,OH,685,685,0,486,197,2,683,48655,66257.54
117751,2017,The Master's University and Seminary,CA,164,153,11,96,55,2,151,40783,71662.94
216278,2017,Susquehanna University,PA,634,634,0,387,245,2,632,64760,72676.24
204617,2017,Ohio Dominican University,OH,244,244,0,231,11,2,242,42524,65362.52
203128,2017,Hiram College,OH,257,257,0,174,81,2,255,50555,63946.73
183062,2017,Keene State College,NH,931,931,0,352,577,2,929,28880,75913.18
240471,2017,University of Wisconsin-River Falls,WI,1325,1325,0,633,690,2,1323,17971,69159.98
200004,2017,Western Carolina University,NC,1998,1984,14,1816,166,2,1982,18462,56230.92
203757,2017,Lourdes University,OH,213,210,3,125,83,2,208,37498,59351.8
236577,2017,Seattle Pacific University,WA,647,629,18,362,265,2,627,60834,72206.46
224527,2017,East Texas Baptist University,TX,424,424,0,373,49,2,422,38749,56363.11
161457,2017,University of New England,ME,651,650,1,193,455,2,648,56844,64934.4
211981,2017,Delaware Valley University,PA,418,418,0,221,196,1,417,56828,74767.83
485546,2017,California Intercontinental University,CA,30,30,0,10,19,1,29,37686.031269160027,64276.692131199976
181604,2017,College of Saint Mary,NE,102,102,0,75,26,1,101,31250,62625.82
174127,2017,Minneapolis College of Art and Design,MN,133,133,0,71,61,1,132,53010,70094.27
212984,2017,Holy Family University,PA,361,361,0,322,38,1,360,37020,61868.46
489937,2017,Piedmont International University,NC,65,64,1,36,27,1,63,22830,64276.692131199976
199157,2017,North Carolina Central University,NC,1275,1270,5,1082,187,1,1269,24075,57501.19
118888,2017,Mills College,CA,174,173,1,129,43,1,172,48360,71756.45
235316,2017,Gonzaga University,WA,1257,1244,13,574,669,1,1243,61761,67848.44
154350,2017,Simpson College,IA,298,298,0,206,91,1,297,53845,60274.33
111188,2017,California State University Maritime Academy,CA,223,223,0,184,38,1,222,28149,78248.99
107071,2017,Henderson State University,AR,617,617,0,517,99,1,616,23005,45548.96
217420,2017,Rhode Island College,RI,1040,1040,0,842,197,1,1039,17761,61569.63
155089,2017,Friends University,KS,176,176,0,125,50,1,175,39879,60343.56
120184,2017,Notre Dame de Namur University,CA,169,169,0,142,26,1,168,37686.031269160027,89560.16
484905,2017,University of North Texas at Dallas,TX,316,316,0,314,1,1,315,18930,64276.692131199976
441937,2017,California State University-Channel Islands,CA,955,955,0,946,8,1,954,25150,78662.36
204006,2017,Miami University-Hamilton,OH,598,598,0,583,14,1,597,16237,72182.76
199281,2017,University of North Carolina at Pembroke,NC,1033,1023,10,984,38,1,1022,15952,49520.51
211556,2017,Chatham University,PA,284,273,11,197,76,0,273,52968,56097.18
203368,2017,John Carroll University,OH,753,746,7,505,241,0,746,57651,68368.11
204200,2017,Mount Saint Joseph University,OH,277,276,1,198,78,0,276,39248,64120.45
198543,2017,Fayetteville State University,NC,670,641,29,614,27,0,641,16623,49808.38
200013,2017,Rasmussen College-North Dakota,ND,39,39,0,33,6,0,39,23022,52350.64
238263,2017,Madison Area Technical College,WI,1687,1654,33,1615,39,0,1654,14210,64533.76
125231,2017,Walden University,MN,128,128,0,0,128,0,128,37686.031269160027,62475.08
219046,2017,Black Hills State University,SD,555,549,6,377,172,0,549,20937,49477.45
216852,2017,Widener University,PA,787,782,5,423,359,0,782,62831,69397.52
474863,2017,Azusa Pacific University College,CA,49,49,0,43,6,0,49,26995,64276.692131199976
163578,2017,Notre Dame of Maryland University,MD,154,154,0,129,25,0,154,52667,70799.46
217925,2017,Columbia International University,SC,88,81,7,57,24,0,81,36979,64434.93
213783,2017,Mansfield University of Pennsylvania,PA,379,379,0,324,55,0,379,24278,51271.33
205443,2017,Shawnee State University,OH,700,693,7,621,72,0,693,16327,43961.17
234915,2017,City University of Seattle,WA,40,39,1,36,3,0,39,37686.031269160027,67486.66
128780,2017,Charter Oak State College,CT,11,10,1,5,5,0,10,16369,63157.4
216357,2017,Thiel College,PA,186,184,2,112,72,0,184,48566,54604.75
130314,2017,University of Saint Joseph,CT,134,134,0,127,7,0,134,50959,74607
198598,2017,Greensboro College,NC,223,195,28,133,62,0,195,30302,63893.94
420042,2017,University of Phoenix-Hawaii,HI,3,3,0,3,0,0,3,18992,62086.89
150604,2017,Franklin College,IN,267,267,0,244,23,0,267,46533,61682.88
180878,2017,Bryan College of Health Sciences,NE,53,53,0,51,2,0,53,30615,58151.07
225414,2017,University of Houston-Clear Lake,TX,280,280,0,280,0,0,280,25567,67975.01
482459,2017,DeVry University-Florida,FL,16,16,0,15,1,0,16,37295,64276.692131199976
438586,2017,American InterContinental University-Atlanta,GA,151,151,0,143,8,0,151,21048,58772.86
157809,2017,Thomas More College,KY,351,351,0,208,143,0,351,42003,64733.74
445133,2017,American InterContinental University-Houston,TX,16,13,3,13,0,0,13,21745,58772.86
456490,2017,Polytechnic University of Puerto Rico-Orlando,FL,19,19,0,19,0,0,19,22583,64276.692131199976
210146,2017,Southern Oregon University,OR,723,722,1,357,365,0,722,17755,54749.32
238430,2017,Cardinal Stritch University,WI,141,141,0,129,12,0,141,44172,64348.07
228981,2017,Texas Lutheran University,TX,417,416,1,407,9,0,416,42208,65468.32
482486,2017,DeVry University-Indiana,IN,2,2,0,2,0,0,2,24764,64276.692131199976
482565,2017,DeVry University-North Carolina,NC,1,1,0,1,0,0,1,37686.031269160027,64276.692131199976
408844,2017,Florida National University-Main Campus,FL,539,539,0,536,3,0,539,28378,51661.46
117575,2017,Southern California Seminary,CA,1,1,0,1,0,0,1,37686.031269160027,61547.27
484710,2017,University of Phoenix-Nevada,NV,1,1,0,1,0,0,1,37686.031269160027,64276.692131199976
130493,2017,Southern Connecticut State University,CT,1379,1375,4,1315,60,0,1375,25413,74581.97
140234,2017,LaGrange College,GA,274,274,0,233,41,0,274,46034,61341.56
211477,2017,Central Penn College,PA,164,162,2,154,8,0,162,27042,56698.35
414878,2017,Trine University-Regional/Non-Traditional Campuses,IN,2,2,0,1,1,0,2,37686.031269160027,60275.33
109785,2017,Azusa Pacific University,CA,1005,974,31,773,201,0,974,56802,73950.46
125763,2017,Whittier College,CA,520,520,0,427,93,0,520,61052,73825.46
199999,2017,Winston-Salem State University,NC,937,932,5,864,68,0,932,20382,54716.68
213303,2017,Keystone College,PA,331,331,0,264,67,0,331,39200,51740.58
224554,2017,Texas A & M University-Commerce,TX,1015,1014,1,984,30,0,1014,22575,57562.14
203465,2017,Kent State University at Stark,OH,652,649,3,648,1,0,649,12914,59479.84
157058,2017,Kentucky State University,KY,318,318,0,129,189,0,318,16885,51636.62
154174,2017,Palmer College of Chiropractic,IA,1,1,0,1,0,0,1,37686.031269160027,59646.88
123651,2017,Vanguard University of Southern California,CA,433,429,4,383,46,0,429,48086,75891.29
211352,2017,Cabrini University,PA,494,458,36,332,126,0,458,46293,77292.03
482608,2017,DeVry University-Pennsylvania,PA,9,9,0,8,1,0,9,34602,64276.692131199976
432223,2017,University of Phoenix-Washington,WA,1,1,0,1,0,0,1,37686.031269160027,64276.692131199976
484668,2017,University of Phoenix-Florida,FL,2,2,0,2,0,0,2,37686.031269160027,64276.692131199976
203960,2017,Mercy College of Ohio,OH,66,66,0,54,12,0,66,22784,58075.98
484631,2017,University of Phoenix-California,CA,23,23,0,23,0,0,23,18184,64276.692131199976
227331,2017,Our Lady of the Lake University,TX,338,338,0,336,2,0,338,40753,52505.04
210401,2017,Willamette University,OR,440,438,2,120,318,0,438,66416,68135.42
156471,2017,Galen College of Nursing-Louisville,KY,37,33,4,23,10,0,33,37686.031269160027,54499.36
205027,2017,Pontifical College Josephinum,OH,11,10,1,3,7,0,10,43542,56364.42
251312,2017,South University-Columbia,SC,17,17,0,17,0,0,17,28397,55764.27
223117,2017,Baptist Missionary Association Theological Seminary,TX,4,3,1,2,1,0,3,37686.031269160027,48842.7
482617,2017,DeVry University-Tennessee,TN,1,1,0,1,0,0,1,37460,64276.692131199976
214883,2017,Peirce College,PA,87,87,0,68,19,0,87,18260,49493.53
458210,2017,West Coast University-Orange County,CA,12,12,0,12,0,0,12,41865,64276.692131199976
230056,2017,Broadview University-West Jordan,UT,14,14,0,13,1,0,14,27859,70004.7
141167,2017,Thomas University,GA,79,65,14,30,35,0,65,27354,45124.61
482635,2017,DeVry University-Texas,TX,6,6,0,6,0,0,6,33151,64276.692131199976
484756,2017,University of Phoenix-Texas,TX,6,6,0,6,0,0,6,16367,64276.692131199976
198507,2017,Elizabeth City State University,NC,349,346,3,319,27,0,346,12754,47337.89
214069,2017,Misericordia University,PA,440,440,0,283,157,0,440,48844,56588.57
174491,2017,University of Northwestern-St Paul,MN,401,401,0,305,96,0,401,43817,70065.41
142461,2017,Northwest Nazarene University,ID,281,281,0,166,115,0,281,42068,59470.41
113582,2017,Design Institute of San Diego,CA,3,3,0,3,0,0,3,42928,71383.01
482468,2017,DeVry University-Georgia,GA,20,20,0,20,0,0,20,34215,64276.692131199976
203474,2017,Kent State University at Trumbull,OH,243,243,0,237,6,0,243,13328,59479.84
204194,2017,Mount Vernon Nazarene University,OH,334,334,0,304,30,0,334,43341,60597.42
133872,2017,Adventist University of Health Sciences,FL,107,107,0,98,9,0,107,33648,60028.37
206279,2017,Union Institute & University,OH,9,9,0,0,9,0,9,31656,59714.64
183257,2017,Granite State College,NH,75,73,2,60,13,0,73,18834,59743.94
224323,2017,University of Dallas,TX,419,401,18,208,193,0,401,58050,75912.69
484677,2017,University of Phoenix-Georgia,GA,1,1,0,1,0,0,1,37686.031269160027,64276.692131199976
490805,2017,Purdue University Northwest,IN,1125,1125,0,1060,65,0,1125,17408,64276.692131199976
132879,2017,Johnson University Florida,FL,56,53,3,50,3,0,53,27611,59004.31
482574,2017,DeVry University-Ohio,OH,42,42,0,42,0,0,42,34949,64276.692131199976
484729,2017,University of Phoenix-North Carolina,NC,2,2,0,2,0,0,2,37686.031269160027,64276.692131199976
124487,2017,Epic Bible College,CA,10,10,0,9,1,0,10,37686.031269160027,63747.56
161217,2017,University of Maine at Augusta,ME,298,298,0,292,6,0,298,16948,48750.5
111966,2017,Charles R Drew University of Medicine and Science,CA,19,18,1,17,1,0,18,33171,55906.67
482547,2017,DeVry University-Nevada,NV,1,1,0,1,0,0,1,34274,64276.692131199976
155812,2017,University of Saint Mary,KS,145,145,0,55,90,0,145,42175,62613.14
139719,2017,Fort Valley State University,GA,521,521,0,479,42,0,521,20264,53364.82
212656,2017,Geneva College,PA,303,299,4,219,80,0,299,38941,55668.91
130226,2017,Quinnipiac University,CT,1966,1946,20,490,1456,0,1946,66237,87986.1
198969,2017,Methodist University,NC,412,392,20,246,146,0,392,55751,58239.21
114123,2017,Empire College,CA,150,150,0,150,0,0,150,37686.031269160027,70826.06
156125,2017,Wichita State University,KS,1541,1507,34,1229,278,0,1507,20418,60078.99
225399,2017,Houston Baptist University,TX,519,514,5,493,21,0,514,43638,72476.33
482431,2017,DeVry University-California,CA,32,31,1,30,1,0,31,35697,64276.692131199976
202763,2017,The University of Findlay,OH,594,592,2,410,182,0,592,47032,61890.4
213774,2017,Manor College,PA,184,184,0,177,7,0,184,25964,60787.72
211431,2017,Carlow University,PA,241,241,0,227,14,0,241,44201,52873.76
128498,2017,Albertus Magnus College,CT,115,115,0,97,18,0,115,49375,65065.75
168847,2017,Baker College,MI,814,814,0,757,57,0,814,19593,59405.88
219471,2017,University of South Dakota,SD,1341,1322,19,814,508,0,1322,23016,53799.09
489779,2017,Kaplan University-Indianapolis,IN,48,48,0,48,0,0,48,37686.031269160027,64276.692131199976
214148,2017,Moore College of Art and Design,PA,89,89,0,44,45,0,89,60910,70661.87
238193,2017,Alverno College,WI,197,191,6,164,27,0,191,40724,58784.16
450571,2017,Rasmussen College-Wisconsin,WI,57,57,0,56,1,0,57,23497,64276.692131199976
180814,2017,Bellevue University,NE,49,48,1,28,20,0,48,22961,63424.91
155681,2017,Pittsburg State University,KS,995,990,5,602,388,0,990,18657,50242.27
236948,2018,University of Washington-Seattle Campus,WA,7161,7161,0,4443,1539,1179,5982,26825,69752.4
110653,2018,University of California-Irvine,CA,5793,5793,0,4516,101,1176,4617,34355,78085.65
110680,2018,University of California-San Diego,CA,6707,6704,3,5168,502,1034,5670,33240,76397.62
204796,2018,Ohio State University-Main Campus,OH,7944,7944,0,5214,1788,942,7002,27202,65208.79
110635,2018,University of California-Berkeley,CA,6012,6008,4,4301,860,847,5161,39016,77601.85
110662,2018,University of California-Los Angeles,CA,6240,6239,1,4378,1154,707,5532,35497,72896.84
110705,2018,University of California-Santa Barbara,CA,5094,5091,3,4021,363,707,4384,36492,73046.19
240444,2018,University of Wisconsin-Madison,WI,6862,6856,6,3629,2660,567,6289,26393,71185.17
133951,2018,Florida International University,FL,4441,4388,53,3724,117,547,3841,19384,58110.89
123961,2018,University of Southern California,CA,3401,3395,6,1425,1448,522,2873,77362,76787.41
140951,2018,Savannah College of Art and Design,GA,2759,2759,0,400,1900,459,2300,58367,71588.69
134130,2018,University of Florida,FL,6792,6763,29,5449,871,443,6320,21151,60120.16
139755,2018,Georgia Institute of Technology-Main Campus,GA,3116,3116,0,1576,1155,385,2731,29291,77933.64
129020,2018,University of Connecticut,CT,3749,3748,1,2492,875,381,3367,33896,80999.86
215062,2018,University of Pennsylvania,PA,2510,2428,82,426,1678,324,2104,78186,78252
228778,2018,The University of Texas at Austin,TX,8960,8960,0,7968,683,309,8651,27397,72284.1
131469,2018,George Washington University,DC,2845,2771,74,30,2433,308,2463,74023,85677.46
170976,2018,University of Michigan-Ann Arbor,MI,6695,6695,0,3546,2849,300,6395,30926,77145.9
212054,2018,Drexel University,PA,3361,3322,39,1477,1556,289,3033,69397,74533.27
211440,2018,Carnegie Mellon University,PA,1572,1572,0,152,1135,285,1287,74489,81652.61
174066,2018,University of Minnesota-Twin Cities,MN,5977,5952,25,3898,1770,284,5668,27654,70741.62
204024,2018,Miami University-Oxford,OH,3936,3933,3,2404,1272,257,3676,33805,72182.76
139658,2018,Emory University,GA,1431,1431,0,211,966,254,1177,72604,80509.92
217156,2018,Brown University,RI,1652,1649,3,58,1345,246,1403,77490,79027.35
227216,2018,University of North Texas,TX,4875,4867,8,4430,199,238,4629,23770,72891.36
122409,2018,San Diego State University,CA,5750,5750,0,4587,930,233,5517,23367,68953.33
181464,2018,University of Nebraska-Lincoln,NE,4816,4769,47,3343,1195,231,4538,24400,60976.73
243744,2018,Stanford University,CA,1696,1696,0,566,903,227,1469,74570,80275.59
137351,2018,University of South Florida-Main Campus,FL,4435,4406,29,3802,388,216,4190,21134,58397.57
221999,2018,Vanderbilt University,TN,1602,1595,7,141,1246,208,1387,73148,76279.78
139940,2018,Georgia State University,GA,4999,4989,10,4008,780,201,4788,27206,72190.32
130794,2018,Yale University,CT,1573,1572,1,118,1258,196,1376,76645,75345.96
122612,2018,University of San Francisco,CA,1542,1531,11,926,410,195,1336,69987,82472.56
215293,2018,University of Pittsburgh-Pittsburgh Campus,PA,4126,4112,14,2475,1449,188,3924,33964,58452.18
228796,2018,The University of Texas at El Paso,TX,3422,3422,0,3151,90,181,3241,18291,46777.52
201645,2018,Case Western Reserve University,OH,1393,1393,0,290,925,178,1215,69526,69873.4
152080,2018,University of Notre Dame,IN,2070,2070,0,147,1747,176,1894,74172,76710.92
199847,2018,Wake Forest University,NC,1421,1421,0,265,981,175,1246,74135,80539.14
209551,2018,University of Oregon,OR,4168,4164,4,2100,1889,175,3989,27717,62294.9
225511,2018,University of Houston,TX,5198,5172,26,4893,109,170,5002,23361,68874.27
201885,2018,University of Cincinnati-Main Campus,OH,5329,5323,6,4275,882,166,5157,26892,64722.83
163286,2018,University of Maryland-College Park,MD,6075,6053,22,3901,1987,165,5888,27343,90010.73
162928,2018,Johns Hopkins University,MD,1420,1394,26,124,1114,156,1238,74001,81539.46
217493,2018,Rhode Island School of Design,RI,473,462,11,13,295,154,308,72571,80568.35
131496,2018,Georgetown University,DC,1621,1618,3,27,1438,153,1465,76280,82187.36
230764,2018,University of Utah,UT,4256,3958,298,2577,1229,152,3806,20303,69474.52
130943,2018,University of Delaware,DE,4705,4698,7,1848,2698,152,4546,28708,84189.75
228769,2018,The University of Texas at Arlington,TX,3572,3572,0,3334,91,147,3425,23902,66876.51
199193,2018,North Carolina State University at Raleigh,NC,4952,4932,20,4232,555,145,4787,24202,64180.75
117946,2018,Loyola Marymount University,CA,1512,1500,12,822,535,143,1357,70235,78631.93
230038,2018,Brigham Young University-Provo,UT,5739,5712,27,1905,3672,135,5577,18936,64914.81
228723,2018,Texas A & M University-College Station,TX,11133,11132,1,10477,522,133,10999,29920,67194.13
198419,2018,Duke University,NC,1745,1694,51,234,1329,131,1563,77846,78468.48
227757,2018,Rice University,TX,958,958,0,369,459,130,828,67102,77707.58
216339,2018,Temple University,PA,5030,5028,2,3596,1303,129,4899,33226,66650.68
207500,2018,University of Oklahoma-Norman Campus,OK,4385,4378,7,2487,1762,129,4249,29577,59522.71
108232,2018,Academy of Art University,CA,570,567,3,203,235,129,438,43976,74015.06
207388,2018,Oklahoma State University-Main Campus,OK,4166,4157,9,2630,1399,128,4029,23906,55237.91
486840,2018,Kennesaw State University,GA,4783,4762,21,4001,637,124,4638,25059,64276.692131199976
137847,2018,The University of Tampa,FL,2164,2154,10,416,1615,123,2031,46341,71934.52
228787,2018,The University of Texas at Dallas,TX,3862,3862,0,3544,199,119,3743,27120,79361.13
223232,2018,Baylor University,TX,3366,3365,1,2069,1180,116,3249,65222,73627.32
163295,2018,Maryland Institute College of Art,MD,425,416,9,69,233,114,302,66413,80395.11
110565,2018,California State University-Fullerton,CA,4408,4408,0,4261,34,113,4295,17791,73036.4
229115,2018,Texas Tech University,TX,6171,6162,9,5675,376,111,6051,23191,65284.89
122931,2018,Santa Clara University,CA,1392,1389,3,745,534,110,1279,74297,93581.09
122755,2018,San Jose State University,CA,3774,3774,0,3623,42,109,3665,25747,88589.14
228875,2018,Texas Christian University,TX,2194,2189,5,873,1208,108,2081,68072,76266.48
204501,2018,Oberlin College,OH,804,804,0,47,649,108,696,77124,76190.1
169080,2018,Calvin College,MI,842,842,0,456,280,106,736,50191,70660.49
110671,2018,University of California-Riverside,CA,4535,4529,6,4393,30,106,4423,30561,68292.12
122597,2018,San Francisco State University,CA,4287,4287,0,4149,32,106,4181,24513,77495.51
133979,2018,Florida Memorial University,FL,341,341,0,191,49,101,240,28157,48349.61
202134,2018,Cleveland State University,OH,1960,1960,0,1774,89,97,1863,24010,57782.89
461148,2018,New York Film Academy,CA,226,224,2,104,23,97,127,54738,64276.692131199976
121150,2018,Pepperdine University,CA,803,793,10,358,338,97,696,75312,79068.51
109651,2018,Art Center College of Design,CA,241,241,0,118,29,94,147,66046,74131.88
151111,2018,Indiana University-Purdue University-Indianapolis,IN,4103,4096,7,3737,265,94,4002,21127,64749.24
160755,2018,Tulane University of Louisiana,LA,1909,1909,0,198,1617,94,1815,75628,69803.28
490133,2018,Westcliff University,CA,105,105,0,9,3,93,12,22466,64276.692131199976
110370,2018,California College of the Arts,CA,263,248,15,90,66,92,156,68956,73343.27
130590,2018,Trinity College,CT,579,579,0,88,402,89,490,76850,81265.21
211273,2018,Bryn Mawr College,PA,391,391,0,38,267,86,305,73540,78969.24
110583,2018,California State University-Long Beach,CA,4912,4912,0,4772,54,86,4826,19846,66954.9
203517,2018,Kent State University at Kent,OH,4396,4386,10,3460,840,86,4300,25836,59479.84
111948,2018,Chapman University,CA,1660,1658,2,1032,546,80,1578,74336,73437.32
236939,2018,Washington State University,WA,5164,5135,29,4005,1052,78,5057,26068,63710
433660,2018,Florida Gulf Coast University,FL,2902,2876,26,2384,415,77,2799,18151,62394.85
228246,2018,Southern Methodist University,TX,1530,1523,7,590,858,75,1448,76346,82038.46
157085,2018,University of Kentucky,KY,5077,5072,5,3201,1798,73,4999,30178,59287.73
211291,2018,Bucknell University,PA,974,974,0,191,711,72,902,75400,84046.3
110608,2018,California State University-Northridge,CA,4804,4804,0,4649,83,72,4732,19794,64055.44
206084,2018,University of Toledo,OH,3270,3261,9,2465,725,71,3190,25118,60626.38
182281,2018,University of Nevada-Las Vegas,NV,4144,4139,5,3345,724,70,4069,18756,70070.97
229027,2018,The University of Texas at San Antonio,TX,4984,4984,0,4825,91,68,4916,18923,63798.29
181394,2018,University of Nebraska at Omaha,NE,2151,2148,3,1874,207,67,2081,19797,66043.01
207971,2018,University of Tulsa,OK,806,784,22,375,345,64,720,58637,62928.78
216597,2018,Villanova University,PA,1688,1687,1,297,1327,63,1624,73042,90091.77
163268,2018,University of Maryland-Baltimore County,MD,1794,1779,15,1599,119,61,1718,25997,83010.29
131159,2018,American University,DC,1758,1729,29,21,1648,60,1669,66416,81657.17
114354,2018,FIDM-Fashion Institute of Design & Merchandising-Los Angeles,CA,436,436,0,187,189,60,376,51281,73476
120403,2018,Otis College of Art and Design,CA,277,273,4,153,61,59,214,66695,73811.67
482680,2018,University of North Georgia,GA,4459,4455,4,4293,105,57,4398,16816,64276.692131199976
112260,2018,Claremont McKenna College,CA,325,324,1,113,154,57,267,76475,82855.72
240453,2018,University of Wisconsin-Milwaukee,WI,3983,3983,0,3443,483,57,3926,21984,65921.14
482158,2018,Middle Georgia State University,GA,1465,1464,1,1215,193,56,1408,15822,64276.692131199976
139931,2018,Georgia Southern University,GA,4345,4343,2,4049,238,56,4287,22608,62772.56
150455,2018,Earlham College,IN,271,270,1,52,162,56,214,61156,66410.88
141574,2018,University of Hawaii at Manoa,HI,2209,2204,5,1355,793,56,2148,23405,71646.27
449339,2018,American Public University System,WV,1324,1324,0,16,1253,55,1269,16569,64276.692131199976
159391,2018,Louisiana State University and Agricultural & Mechanical College,LA,5812,5808,4,4455,1299,54,5754,32724,57504.74
106245,2018,University of Arkansas at Little Rock,AR,601,601,0,513,35,53,548,20416,51732.17
122436,2018,University of San Diego,CA,1310,1303,7,718,532,53,1250,70440,79883.39
129242,2018,Fairfield University,CT,1091,1091,0,216,823,52,1039,67080,93458.99
202480,2018,University of Dayton,OH,2200,2200,0,1069,1079,52,2148,60900,75690.27
120883,2018,University of the Pacific,CA,954,949,5,812,85,52,897,64784,72621.06
156365,2018,Campbellsville University,KY,666,666,0,537,77,52,614,38502,47586.61
201441,2018,Bowling Green State University-Main Campus,OH,3273,3271,2,2870,350,51,3220,24529,63749.73
134097,2018,Florida State University,FL,6324,6324,0,5454,819,51,6273,22278,60914.47
220862,2018,University of Memphis,TN,2480,2479,1,2125,304,50,2429,24139,58823.6
399911,2018,Soka University of America,CA,111,111,0,27,34,50,61,50968,79623.38
218663,2018,University of South Carolina-Columbia,SC,5854,5826,28,3012,2765,49,5777,28602,62188.24
227368,2018,The University of Texas Rio Grande Valley,TX,4565,4565,0,4504,12,49,4516,14250,35906.7
151263,2018,University of Indianapolis,IN,1222,1221,1,1006,169,46,1175,44681,63891.1
217165,2018,Bryant University,RI,867,867,0,93,728,46,821,62855,80219.8
220978,2018,Middle Tennessee State University,TN,2897,2897,0,2618,233,46,2851,21241,60340.43
228802,2018,The University of Texas at Tyler,TX,907,907,0,845,16,46,861,20730,53622.93
240426,2018,University of Wisconsin-Superior,WI,326,326,0,145,136,45,281,18731,53835.5
136950,2018,Rollins College,FL,549,546,3,313,188,45,501,66805,69363.5
221759,2018,The University of Tennessee-Knoxville,TN,5215,5214,1,3992,1177,45,5169,32010,60752.93
141644,2018,Hawaii Pacific University,HI,571,564,7,247,272,45,519,47698,72804.49
187985,2018,University of New Mexico-Main Campus,NM,2653,2627,26,2201,381,45,2582,19351,49538.77
110617,2018,California State University-Sacramento,CA,3757,3757,0,3665,47,45,3712,21576,65686.13
139959,2018,University of Georgia,GA,5727,5722,5,4809,869,44,5678,27329,71225.06
110556,2018,California State University-Fresno,CA,3574,3574,0,3512,19,43,3531,17683,53295.09
230816,2018,Bennington College,VT,202,202,0,7,152,43,159,75972,77879.63
135081,2018,Keiser University-Ft Lauderdale,FL,4887,4686,201,3744,899,43,4643,40713,55699.66
188030,2018,New Mexico State University-Main Campus,NM,2264,2258,6,1535,682,41,2217,19760,43867.23
206941,2018,University of Central Oklahoma,OK,2066,2066,0,1952,73,41,2025,24185,54764.86
111081,2018,California Institute of the Arts,CA,215,214,1,100,73,41,173,74111,74875.2
222831,2018,Angelo State University,TX,1536,1536,0,1460,35,41,1495,19810,49632.36
110529,2018,California State Polytechnic University-Pomona,CA,3863,3863,0,3735,88,40,3823,22365,68064.96
169798,2018,Eastern Michigan University,MI,2404,2403,1,2014,350,39,2364,24994,69989
134945,2018,Jacksonville University,FL,624,622,2,301,282,39,583,54991,63671.93
117140,2018,University of La Verne,CA,673,665,8,596,30,39,626,60759,67082.29
120254,2018,Occidental College,CA,566,566,0,210,317,39,527,76600,75275.66
199412,2018,Queens University of Charlotte,NC,369,369,0,163,168,38,331,49480,69597.25
168740,2018,Andrews University,MI,296,292,4,83,171,38,254,40948,63096.48
130226,2018,Quinnipiac University,CT,1899,1897,2,448,1412,37,1860,66237,87986.1
209922,2018,Reed College,OR,363,363,0,20,306,37,326,75586,71777.6
172644,2018,Wayne State University,MI,3038,3017,21,2934,47,36,2981,24541,61912.62
219000,2018,Augustana University,SD,456,455,1,202,217,36,419,47710,60196.68
160658,2018,University of Louisiana at Lafayette,LA,2733,2733,0,2576,121,36,2697,22948,47090.8
228149,2018,St. Mary's University,TX,640,640,0,550,54,36,604,42354,56236.53
110361,2018,California Baptist University,CA,1603,1603,0,1430,137,36,1567,48731,66849.57
169716,2018,University of Detroit Mercy,MI,583,580,3,499,45,36,544,38440,64142.33
204857,2018,Ohio University-Main Campus,OH,3993,3992,1,3424,532,36,3956,29534,59563.35
151102,2018,Purdue University Fort Wayne,IN,1553,1553,0,1419,98,36,1517,19224,61940.3
107044,2018,Harding University,AR,857,857,0,232,590,35,822,31647,61757.88
200800,2018,University of Akron Main Campus,OH,2815,2814,1,2627,152,35,2779,24604,58778.75
110097,2018,Biola University,CA,866,861,5,604,223,34,827,58012,75484.4
230995,2018,Norwich University,VT,682,682,0,82,566,34,648,59627,68974.52
240462,2018,University of Wisconsin-Platteville,WI,1672,1672,0,1292,346,34,1638,18670,61602.16
215655,2018,Robert Morris University,PA,817,817,0,658,125,34,783,47724,59274.33
163204,2018,University of Maryland-University College,MD,704,700,4,232,434,34,666,19764,73191.4
170082,2018,Grand Valley State University,MI,4311,4311,0,3837,441,33,4278,24280,67198.25
129525,2018,University of Hartford,CT,1220,1219,1,500,686,33,1186,57475,82221.8
227845,2018,Saint Edward's University,TX,804,793,11,639,122,32,761,61707,71197.81
198969,2018,Methodist University,NC,385,385,0,241,112,32,353,55751,58239.21
131399,2018,University of the District of Columbia,DC,617,610,7,495,83,32,578,22638,51576.54
110060,2018,Bethesda University,CA,62,62,0,26,5,31,31,22453,73410.31
174914,2018,University of St Thomas,MN,1759,1759,0,1366,362,31,1728,57785,76939.14
172051,2018,Saginaw Valley State University,MI,1577,1577,0,1510,36,31,1546,22353,57827.75
128744,2018,University of Bridgeport,CT,523,523,0,290,202,31,492,53853,63241.6
150163,2018,Butler University,IN,1326,1326,0,525,770,31,1295,61623,71968.39
485768,2018,Atlantis University,FL,115,98,17,45,23,30,68,24942,64276.692131199976
118541,2018,Marymount California University,CA,151,151,0,103,18,30,121,51791,73970.25
132903,2018,University of Central Florida,FL,7229,7206,23,6652,524,30,7176,21309,62518.63
217235,2018,Johnson & Wales University-Providence,RI,1445,1445,0,242,1173,30,1415,51167,68856.12
132471,2018,Barry University,FL,644,640,4,361,250,29,611,47118,58621.88
199069,2018,University of Mount Olive,NC,336,335,1,263,43,29,306,32055,51727.18
224147,2018,Texas A & M University-Corpus Christi,TX,2050,2050,0,1963,58,29,2021,22459,54287.8
239105,2018,Marquette University,WI,2164,2164,0,688,1447,29,2135,59725,75591.25
110486,2018,California State University-Bakersfield,CA,1494,1494,0,1446,19,29,1465,18661,53982.7
107141,2018,John Brown University,AR,319,319,0,116,174,29,290,40774,56884.69
102553,2018,University of Alaska Anchorage,AK,1607,1606,1,1503,74,29,1577,18946,72116.59
110592,2018,California State University-Los Angeles,CA,3862,3862,0,3821,13,28,3834,15307,52850.08
157447,2018,Northern Kentucky University,KY,1980,1980,0,1423,529,28,1952,17869,63568.77
181002,2018,Creighton University,NE,1155,1147,8,243,876,28,1119,56120,68443.5
181215,2018,University of Nebraska at Kearney,NE,944,944,0,849,67,28,916,23319,51335.53
221953,2018,Tusculum University,TN,285,285,0,164,94,27,258,39440,49705.55
142115,2018,Boise State University,ID,2884,2883,1,1567,1289,27,2856,21621,58298.66
139366,2018,Columbus State University,GA,1069,1069,0,971,71,27,1042,19807,55979.92
229267,2018,Trinity University,TX,690,689,1,497,165,27,662,60664,78650.29
154527,2018,Wartburg College,IA,469,469,0,305,137,27,442,55508,58222.9
366711,2018,California State University-San Marcos,CA,2474,2474,0,2385,63,26,2448,22531,72827.06
219471,2018,University of South Dakota,SD,1427,1425,2,872,527,26,1399,23016,53799.09
168528,2018,Adrian College,MI,634,633,1,447,160,26,607,54621,66915.1
157289,2018,University of Louisville,KY,2932,2932,0,2306,601,25,2907,28247,59042.66
206604,2018,Wright State University-Main Campus,OH,1920,1918,2,1826,67,25,1893,23009,61970.64
142285,2018,University of Idaho,ID,1434,1404,30,1001,378,25,1379,21525,54125.14
169248,2018,Central Michigan University,MI,2732,2732,0,2437,270,25,2707,25078,66048.2
225627,2018,University of the Incarnate Word,TX,822,820,2,772,24,24,796,45532,59715.43
131520,2018,Howard University,DC,1501,1501,0,18,1459,24,1477,45971,66680.2
139311,2018,Clayton  State University,GA,650,650,0,608,18,24,626,18374,65444.71
174358,2018,Minnesota State University Moorhead,MN,796,793,3,521,248,24,769,22525,54641.42
138293,2018,Webber International University,FL,187,187,0,147,16,24,163,42702,55372.47
229160,2018,Texas Wesleyan University,TX,299,299,0,250,25,24,275,47135,62890.39
198950,2018,Meredith College,NC,401,401,0,342,35,24,377,50390,66301.42
173300,2018,Concordia College at Moorhead,MN,597,597,0,411,162,24,573,53819,60523.09
226091,2018,Lamar University,TX,1535,1535,0,1484,27,24,1511,20362,53474.77
141334,2018,University of West Georgia,GA,2289,2231,58,2190,18,23,2208,23684,66454.08
151290,2018,Indiana Institute of Technology,IN,433,433,0,241,169,23,410,40161,60972.77
221351,2018,Rhodes College,TN,543,543,0,152,368,23,520,64249,73395.81
219718,2018,Bethel University,TN,412,412,0,313,76,23,389,30992,50031.89
199139,2018,University of North Carolina at Charlotte,NC,3708,3664,44,3403,238,23,3641,23478,65762.02
137476,2018,St. Thomas University,FL,208,197,11,164,10,23,174,46539,56846.82
163976,2018,St. John's College,MD,122,122,0,17,82,23,99,50001,72041.37
377555,2018,University of Washington-Bothell Campus,WA,781,781,0,748,11,22,759,23189,69752.4
168847,2018,Baker College,MI,745,743,2,678,43,22,721,19593,59405.88
209056,2018,Lewis & Clark College,OR,562,562,0,58,482,22,540,68735,69786.29
240277,2018,University of Wisconsin-Green Bay,WI,1306,1306,0,1191,93,22,1284,17509,63413.11
209807,2018,Portland State University,OR,1876,1874,2,1357,495,22,1852,20571,62889.32
226833,2018,Midwestern State University,TX,897,895,2,847,26,22,873,19972,57712.44
217882,2018,Clemson University,SC,3789,3785,4,2284,1479,22,3763,32254,64586.36
219976,2018,Lipscomb University,TN,671,669,2,376,271,22,647,49074,66979.13
128771,2018,Central Connecticut State University,CT,1464,1464,0,1372,70,22,1442,22518,75579.11
226152,2018,Texas A & M International University,TX,1356,1356,0,1322,12,22,1334,13408,43910.56
237330,2018,Concord University,WV,430,430,0,308,101,21,409,16824,41360.98
229063,2018,Texas Southern University,TX,1607,1607,0,1350,236,21,1586,23173,53781.71
213020,2018,Indiana University of Pennsylvania-Main Campus,PA,2132,2132,0,2002,109,21,2111,28442,54158.04
182290,2018,University of Nevada-Reno,NV,3691,3690,1,2689,980,21,3669,23256,68050.29
213996,2018,Messiah College,PA,647,647,0,381,245,21,626,49864,71914.01
159647,2018,Louisiana Tech University,LA,2186,2186,0,1870,295,21,2165,21927,46738.12
236595,2018,Seattle University,WA,1083,1083,0,393,669,21,1062,63439,70785.55
212106,2018,Duquesne University,PA,1512,1509,3,1085,404,20,1489,56199,61274.66
156213,2018,Asbury University,KY,279,270,9,146,104,20,250,42462,61842.48
110574,2018,California State University-East Bay,CA,1459,1459,0,1423,16,20,1439,23357,78750.43
201654,2018,Cedarville University,OH,911,911,0,354,537,20,891,42318,67472.37
199962,2018,Wingate University,NC,933,933,0,649,264,20,913,49769,65044.99
217819,2018,College of Charleston,SC,2199,2196,3,1151,1025,20,2176,29545,66962.7
213367,2018,La Salle University,PA,1049,1049,0,740,289,20,1029,45298,67401.72
156082,2018,Washburn University,KS,791,777,14,691,66,20,757,20011,57541.98
219949,2018,Cumberland University,TN,602,601,1,540,42,19,582,38392,59163.95
217484,2018,University of Rhode Island,RI,3058,3053,5,1271,1763,19,3034,30339,72503.8
237066,2018,Whitworth University,WA,696,696,0,482,195,19,677,60359,63739.65
110404,2018,California Institute of Technology,CA,231,231,0,87,125,19,212,74763,81448.64
234827,2018,Central Washington University,WA,2072,2070,2,1912,139,19,2051,24008,63170.67
229814,2018,West Texas A & M University,TX,1205,1203,2,1028,156,19,1184,20456,51385.91
240480,2018,University of Wisconsin-Stevens Point,WI,1790,1790,0,1563,209,18,1772,18217,62211.59
153162,2018,Cornell College,IA,296,296,0,60,218,18,278,58201,67428.42
152530,2018,Taylor University,IN,532,531,1,232,281,18,513,48656,68822.46
218070,2018,Furman University,SC,713,709,4,188,503,18,691,67299,71867.28
213251,2018,Juniata College,PA,350,349,1,221,110,18,331,61807,62290.9
221740,2018,The University of Tennessee-Chattanooga,TN,2268,2267,1,2112,138,17,2250,23436,55964.16
110413,2018,California Lutheran University,CA,681,681,0,573,91,17,664,60668,81648.78
206622,2018,Xavier University,OH,1401,1400,1,528,855,17,1383,58260,68472.8
198695,2018,High Point University,NC,1423,1423,0,382,1024,17,1406,54296,63207.13
239318,2018,Milwaukee School of Engineering,WI,597,597,0,357,223,17,580,53885,68757.09
136330,2018,Palm Beach Atlantic University,FL,526,526,0,296,213,17,509,49839,64221.06
129941,2018,University of New Haven,CT,1338,1337,1,529,791,17,1320,58438,77310.15
169442,2018,College for Creative Studies,MI,254,254,0,197,40,17,237,57085,74293.04
110538,2018,California State University-Chico,CA,2725,2725,0,2681,27,17,2708,25073,61867.44
169910,2018,Ferris State University,MI,1890,1881,9,1753,111,17,1864,23106,61040.62
122506,2018,San Francisco Conservatory of Music,CA,61,61,0,17,28,16,45,69135,74879.37
112075,2018,Concordia University-Irvine,CA,319,318,1,208,94,16,302,53235,79890.85
151342,2018,Indiana University-South Bend,IN,929,929,0,880,33,16,913,16667,59249.25
176053,2018,Mississippi College,MS,523,523,0,289,218,16,507,34918,52824.92
213349,2018,Kutztown University of Pennsylvania,PA,1640,1640,0,1385,239,16,1624,28414,67783.54
154235,2018,Saint Ambrose University,IA,506,506,0,113,377,16,490,46894,63314.56
130183,2018,Post University,CT,939,727,212,134,577,16,711,30161,67090.63
207661,2018,Rogers State University,OK,609,608,1,564,28,16,592,20029,50487.79
209825,2018,University of Portland,OR,1004,996,8,259,722,15,981,64049,67900.72
218742,2018,University of South Carolina-Upstate,SC,1011,1002,9,940,47,15,987,23660,54689.19
206437,2018,Walsh University,OH,453,453,0,388,50,15,438,42869,58552.19
216278,2018,Susquehanna University,PA,619,619,0,382,222,15,604,64760,72676.24
174020,2018,Metropolitan State University,MN,176,176,0,158,3,15,161,22819,69981.95
134237,2018,Full Sail University,FL,2689,2689,0,546,2128,15,2674,35865,66113.73
207856,2018,Southwestern Christian University,OK,134,134,0,75,44,15,119,28315,50467
230834,2018,Castleton University,VT,424,424,0,230,179,15,409,24841,61392.97
110510,2018,California State University-San Bernardino,CA,2682,2682,0,2664,3,15,2667,19114,59070.9
217402,2018,Providence College,RI,1122,1122,0,96,1011,15,1107,69407,83293.65
156620,2018,Eastern Kentucky University,KY,2426,2426,0,2135,277,14,2412,23384,47617.36
228705,2018,Texas A & M University-Kingsville,TX,1251,1249,2,1225,10,14,1235,22645,45266.24
198561,2018,Gardner-Webb University,NC,409,407,2,258,135,14,393,45333,54757.84
200332,2018,North Dakota State University-Main Campus,ND,2275,2275,0,796,1465,14,2261,22201,55831.54
198136,2018,Campbell University,NC,830,827,3,632,181,14,813,51131,56906.03
199643,2018,Shaw University,NC,391,391,0,211,166,14,377,29686,53196.27
240417,2018,University of Wisconsin-Stout,WI,1406,1406,0,874,518,14,1392,19704,65020.23
213358,2018,La Roche University,PA,225,225,0,171,40,14,211,43073,61014.96
227881,2018,Sam Houston State University,TX,2883,2883,0,2825,44,14,2869,22885,63900.24
217873,2018,Claflin University,SC,572,572,0,473,86,13,559,33777,45792.28
218645,2018,University of South Carolina-Aiken,SC,549,548,1,490,45,13,535,20735,53123.12
141167,2018,Thomas University,GA,83,83,0,35,35,13,70,27354,45124.61
206048,2018,Tiffin University,OH,481,481,0,350,118,13,468,41055,59678.08
123554,2018,Saint Mary's College of California,CA,627,627,0,520,94,13,614,69071,84232.87
230807,2018,Westminster College,UT,438,438,0,267,158,13,425,49060,70649.66
138600,2018,Agnes Scott College,GA,324,323,1,192,118,13,310,55403,69580.95
198215,2018,Catawba College,NC,338,337,1,241,83,13,324,44235,60564.51
175980,2018,Millsaps College,MS,245,236,9,109,114,13,223,57996,56763.17
133650,2018,Florida Agricultural and Mechanical University,FL,1421,1419,2,1102,304,13,1406,23312,52786.24
171571,2018,Oakland University,MI,2700,2700,0,2623,64,13,2687,23778,78696.54
199218,2018,University of North Carolina Wilmington,NC,2161,2132,29,1829,290,13,2119,24837,62176.12
198899,2018,Mars Hill University,NC,264,223,41,172,38,13,210,45406,56558.51
141237,2018,Truett McConnell University,GA,285,285,0,246,27,12,273,33299,62186.38
197869,2018,Appalachian State University,NC,3445,3443,2,3125,306,12,3431,19661,61267.04
163046,2018,Loyola University Maryland,MD,1069,1068,1,209,847,12,1056,67196,92129.84
240189,2018,University of Wisconsin-Whitewater,WI,2180,2180,0,1851,317,12,2168,18252,67955.05
174817,2018,Saint Mary's University of Minnesota,MN,306,306,0,154,140,12,294,49200,70833.22
130253,2018,Sacred Heart University,CT,1465,1463,2,371,1080,12,1451,61591,87263.76
125763,2018,Whittier College,CA,512,509,3,399,98,12,497,61052,73825.46
217721,2018,Benedict College,SC,711,711,0,383,316,12,699,28000,49336.04
219709,2018,Belmont University,TN,1568,1560,8,426,1122,12,1548,54595,70368.62
229018,2018,The University of Texas of the Permian Basin,TX,384,384,0,359,13,12,372,17323,47475.29
219833,2018,Christian Brothers University,TN,395,395,0,278,105,12,383,43939,61225.91
414823,2018,Johnson & Wales University-North Miami,FL,372,372,0,197,163,12,360,37686.031269160027,68856.12
183026,2018,Southern New Hampshire University,NH,9347,9169,178,807,8350,12,9157,50505,71986.54
216038,2018,Slippery Rock University of Pennsylvania,PA,1554,1554,0,1384,158,12,1542,24600,54113.09
123165,2018,Scripps College,CA,252,251,1,92,147,12,239,77588,79153.99
152567,2018,Trine University,IN,641,641,0,376,254,11,630,47142,60275.33
214175,2018,Muhlenberg College,PA,548,548,0,149,388,11,537,69413,89504.61
162283,2018,Coppin State University,MD,408,402,6,306,85,11,391,17787,54222.17
204617,2018,Ohio Dominican University,OH,260,260,0,231,18,11,249,42524,65362.52
221892,2018,Trevecca Nazarene University,TN,380,378,2,242,125,11,367,34473,59625.44
214166,2018,Mount Aloysius College,PA,254,254,0,221,22,11,243,36886,45385.58
170037,2018,Cornerstone University,MI,285,285,0,225,49,11,274,35814,63718.46
168786,2018,Aquinas College,MI,333,333,0,279,43,11,322,43921,64829.33
175272,2018,Winona State University,MN,1538,1538,0,1006,521,11,1527,22003,68678.3
482149,2018,Augusta University,GA,1074,1074,0,1009,54,11,1063,20115,64276.692131199976
218229,2018,Lander University,SC,870,870,0,818,41,11,859,24474,52256.85
203580,2018,Lake Erie College,OH,197,196,1,125,60,11,185,45740,63624.4
199698,2018,St. Andrews University,NC,190,189,1,104,74,11,178,44686,64861.88
215770,2018,Saint Joseph's University,PA,1130,1125,5,482,632,11,1114,63223,79940.44
140960,2018,Savannah State University,GA,795,795,0,624,161,10,785,16819,54220.88
236133,2018,Northwest University,WA,220,219,1,149,60,10,209,45095,71872.75
181738,2018,Union College,NE,154,154,0,18,126,10,144,36243,60804.76
117751,2018,The Master's University and Seminary,CA,269,269,0,152,107,10,259,40783,71662.94
240471,2018,University of Wisconsin-River Falls,WI,1314,1314,0,626,678,10,1304,17971,69159.98
162210,2018,Washington Adventist University,MD,177,174,3,103,61,10,164,33721,69837.96
151777,2018,Manchester University,IN,410,408,2,305,93,10,398,45489,60877.57
217907,2018,Coker College,SC,294,294,0,196,88,10,284,42395,49143.33
175856,2018,Jackson State University,MS,831,831,0,306,515,10,821,24570,43401.54
117627,2018,La Sierra University,CA,356,356,0,313,33,10,346,45629,63313.83
197911,2018,Barton College,NC,277,277,0,178,89,10,267,46539,54814.93
153269,2018,Drake University,IA,750,750,0,263,477,10,740,57643,70375.31
159416,2018,Louisiana State University-Shreveport,LA,293,293,0,272,12,9,284,19065,47946.96
140447,2018,Mercer University,GA,1003,1003,0,856,138,9,994,52940,67164.94
211893,2018,Curtis Institute of Music,PA,26,26,0,4,13,9,17,22192,70406
204185,2018,University of Mount Union,OH,625,625,0,452,164,9,616,44497,61044.98
217864,2018,Citadel Military College of South Carolina,SC,703,703,0,378,316,9,694,30022,66736.53
134079,2018,Florida Southern College,FL,707,660,47,415,236,9,651,52794,60789.21
221731,2018,Tennessee Wesleyan University,TN,188,188,0,154,25,9,179,33219,48462.92
207458,2018,Oklahoma City University,OK,373,372,1,148,215,9,363,44942,59190.63
207403,2018,Oklahoma Baptist University,OK,527,525,2,329,187,9,516,42983,59289.35
172264,2018,Siena Heights University,MI,291,291,0,228,54,9,282,39539,63208.96
225247,2018,Hardin-Simmons University,TX,484,484,0,463,12,9,475,42530,59593.97
181783,2018,Wayne State College,NE,721,721,0,614,98,9,712,19521,51810.1
122454,2018,San Francisco Art Institute,CA,53,51,2,26,16,9,42,70023,72969.6
155335,2018,Newman University,KS,183,183,0,142,32,9,174,41633,62008.99
221838,2018,Tennessee State University,TN,1225,1225,0,455,761,9,1216,22509,53809.87
409698,2018,California State University-Monterey Bay,CA,1000,1000,0,959,32,9,991,23389,70802.17
202073,2018,Cleveland Institute of Music,OH,62,61,1,8,44,9,52,60680,78065.66
231059,2018,Saint Michael's College,VT,449,448,1,55,384,9,439,61892,75427.87
207847,2018,Southeastern Oklahoma State University,OK,587,587,0,405,173,9,578,16367,41386.98
215442,2018,Point Park University,PA,616,616,0,392,216,8,608,45350,54201.1
201371,2018,Bluffton University,OH,176,176,0,141,27,8,168,48205,59827.57
240374,2018,University of Wisconsin-Parkside,WI,646,646,0,550,88,8,638,16320,64274.59
217925,2018,Columbia International University,SC,109,101,8,47,46,8,93,36979,64434.93
203845,2018,Marietta College,OH,347,347,0,214,125,8,339,49601,58715.65
377564,2018,University of Washington-Tacoma Campus,WA,653,653,0,626,19,8,645,21705,69752.4
227526,2018,Prairie View A & M University,TX,2177,2177,0,1937,232,8,2169,25164,57579.55
154688,2018,Baker University,KS,247,247,0,179,60,8,239,44473,67758.92
173328,2018,Concordia University-Saint Paul,MN,244,244,0,193,43,8,236,32686,71270.22
222178,2018,Abilene Christian University,TX,924,918,6,813,97,8,910,51577,67136.19
154013,2018,Mount Mercy University,IA,240,240,0,190,42,8,232,48189,61693.27
204264,2018,Muskingum University,OH,369,369,0,319,42,8,361,41716,57566.05
199184,2018,University of North Carolina School of the Arts,NC,243,242,1,113,121,8,234,21755,68862.71
199148,2018,University of North Carolina at Greensboro,NC,2989,2963,26,2854,101,8,2955,19179,60658.11
212656,2018,Geneva College,PA,306,276,30,203,65,8,268,38941,55668.91
204468,2018,Notre Dame College,OH,297,297,0,220,69,8,289,43425,60228.48
153375,2018,Grand View University,IA,329,328,1,266,54,8,320,39864,62140.86
198303,2018,Chowan University,NC,414,414,0,234,172,8,406,37161,53634.23
134811,2018,AI Miami International University of Art and Design,FL,195,195,0,170,17,8,187,27974,57565.03
151379,2018,Indiana University-Southeast,IN,1012,1012,0,741,263,8,1004,17421,57669.69
181127,2018,Hastings College,NE,263,263,0,133,123,7,256,44893,58174.49
210331,2018,Corban University,OR,226,203,23,115,81,7,196,45919,61069.68
214971,2018,Pennsylvania Academy of the Fine Arts,PA,34,34,0,5,22,7,27,62147,70798.99
138868,2018,Point University,GA,247,247,0,186,54,7,240,34160,69033.68
200004,2018,Western Carolina University,NC,2198,2172,26,1869,296,7,2165,18462,56230.92
230959,2018,Middlebury College,VT,628,566,62,25,534,7,559,74248,77169.17
151801,2018,Indiana Wesleyan University-Marion,IN,718,718,0,399,312,7,711,39347,62930.13
209612,2018,Pacific University,OR,421,421,0,182,232,7,414,62157,64591.02
173045,2018,Augsburg University,MN,418,418,0,365,46,7,411,54069,72224.74
218539,2018,Presbyterian College,SC,310,310,0,222,81,7,303,53720,62666.83
129215,2018,Eastern Connecticut State University,CT,973,973,0,832,134,7,966,27425,76020.15
199102,2018,North Carolina A & T State University,NC,2204,2178,26,1547,624,7,2171,18348,56398.61
217536,2018,Salve Regina University,RI,493,493,0,59,427,7,486,61072,81126.67
169479,2018,Davenport University,MI,651,648,3,603,38,7,641,31321,56679.53
212197,2018,Elizabethtown College,PA,386,386,0,265,114,7,379,44978,70213.56
163338,2018,University of Maryland Eastern Shore,MD,505,505,0,384,114,7,498,24348,66039.83
107071,2018,Henderson State University,AR,849,849,0,700,142,7,842,23005,45548.96
170967,2018,Rochester College,MI,139,139,0,124,8,7,132,33013,72043.03
225432,2018,University of Houston-Downtown,TX,1068,1068,0,1058,3,7,1061,20995,59551.33
201548,2018,Capital University,OH,589,589,0,549,33,7,582,47719,64246.32
163453,2018,Morgan State University,MD,1335,1335,0,858,470,7,1328,23254,63566.62
152099,2018,Oakland City University,IN,140,140,0,107,26,7,133,37683,52931.31
228468,2018,Southwestern Adventist University,TX,128,128,0,90,31,7,121,31865,57388.77
213598,2018,Lincoln University,PA,542,542,0,263,272,7,535,26008,51404.66
236230,2018,Pacific Lutheran University,WA,649,649,0,474,168,7,642,56830,65366.76
131283,2018,Catholic University of America,DC,834,796,38,20,769,7,789,65857,85196.61
214041,2018,Millersville University of Pennsylvania,PA,1380,1380,0,1226,147,7,1373,27526,65479.69
125897,2018,Woodbury University,CA,180,175,5,138,30,7,168,55032,60713.37
218654,2018,University of South Carolina-Beaufort,SC,413,411,2,343,62,6,405,24235,60345.78
224323,2018,University of Dallas,TX,376,375,1,216,153,6,369,58050,75912.69
180595,2018,Rocky Mountain College,MT,252,252,0,131,115,6,246,40804,51454.11
160630,2018,Southern University at New Orleans,LA,194,194,0,180,8,6,188,16762,43920.92
139764,2018,Georgia Southwestern State University,GA,415,415,0,390,19,6,409,19125,49591.36
154101,2018,Northwestern College,IA,271,271,0,125,140,6,265,45760,58600.59
217518,2018,Roger Williams University,RI,1040,1036,4,116,914,6,1030,54865,84094.11
204194,2018,Mount Vernon Nazarene University,OH,373,373,0,319,48,6,367,43341,60597.42
238661,2018,Edgewood College,WI,255,255,0,226,23,6,249,44826,68115.77
174491,2018,University of Northwestern-St Paul,MN,418,418,0,314,98,6,412,43817,70065.41
237118,2018,Alderson Broaddus University,WV,256,256,0,76,174,6,250,42676,44559.33
486901,2018,Milligan College,TN,175,155,20,110,39,6,149,46072,64276.692131199976
203757,2018,Lourdes University,OH,193,189,4,122,61,6,183,37498,59351.8
207324,2018,Oklahoma Christian University,OK,454,454,0,201,247,6,448,37015,63431.55
155900,2018,Southwestern College,KS,187,187,0,65,116,6,181,46869,58156.66
132879,2018,Johnson University Florida,FL,68,68,0,54,8,6,62,27611,59004.31
180179,2018,Montana State University Billings,MT,639,639,0,573,60,6,633,16755,48720.57
220701,2018,Martin Methodist College,TN,276,276,0,207,63,6,270,40576,49230.32
181330,2018,Midland University,NE,330,330,0,183,141,6,324,45689,56723.06
210429,2018,Western Oregon University,OR,817,805,12,622,177,6,799,22810,59410.15
138947,2018,Clark Atlanta University,GA,921,918,3,220,692,6,912,39194,60451.55
107512,2018,Ouachita Baptist University,AR,443,443,0,270,168,5,438,40200,61306.22
155627,2018,Ottawa University-Ottawa,KS,244,196,48,77,114,5,191,47369,65346.8
238476,2018,Carthage College,WI,763,763,0,270,488,5,758,59175,76392.24
141325,2018,Wesleyan College,GA,158,158,0,134,19,5,153,34952,57826.42
198613,2018,Guilford College,NC,360,360,0,254,101,5,355,53479,63141.25
215105,2018,The University of the Arts,PA,425,425,0,155,265,5,420,65881,75947.63
217688,2018,Charleston Southern University,SC,585,585,0,439,141,5,580,40177,57179.15
236328,2018,University of Puget Sound,WA,653,653,0,169,479,5,648,68072,72356.02
216667,2018,Washington & Jefferson College,PA,351,351,0,251,95,5,346,62814,61376.37
131450,2018,Gallaudet University,DC,201,201,0,2,194,5,196,38892,65746.56
439701,2018,The King's University,TX,19,19,0,14,0,5,14,22284,68510.99
155520,2018,MidAmerica Nazarene University,KS,167,167,0,84,78,5,162,48863,69737.68
236577,2018,Seattle Pacific University,WA,714,700,14,421,274,5,695,60834,72206.46
216010,2018,Shippensburg University of Pennsylvania,PA,1357,1357,0,1252,100,5,1352,29182,63560.54
235097,2018,Eastern Washington University,WA,1758,1749,9,1646,98,5,1744,20480,56952.77
227863,2018,University of St Thomas,TX,355,355,0,343,7,5,350,42652,71790.89
199865,2018,Warren Wilson College,NC,251,248,3,105,138,5,243,52526,70885.71
204635,2018,Ohio Northern University,OH,682,682,0,558,119,5,677,49392,63536.16
202514,2018,Defiance College,OH,157,157,0,88,64,5,152,46420,61079.24
208822,2018,George Fox University,OR,594,593,1,289,299,5,588,51439,65616.22
441937,2018,California State University-Channel Islands,CA,970,970,0,956,9,5,965,25150,78662.36
175421,2018,Belhaven University,MS,227,227,0,101,121,5,222,35975,57705.44
219790,2018,Bryan College-Dayton,TN,192,192,0,125,63,4,188,38061,56756.79
221661,2018,Southern Adventist University,TN,502,478,24,106,368,4,474,35820,60144.84
226383,2018,Lubbock Christian University,TX,294,294,0,251,39,4,290,37198,51468.15
156286,2018,Bellarmine University,KY,653,653,0,480,169,4,649,56319,65601.28
212160,2018,Edinboro University of Pennsylvania,PA,598,598,0,535,59,4,594,22036,52799.06
206349,2018,Ursuline College,OH,96,96,0,80,12,4,92,44600,60856.87
202903,2018,Gods Bible School and College,OH,42,42,0,16,22,4,38,15632,53235.79
140234,2018,LaGrange College,GA,211,211,0,177,30,4,207,46034,61341.56
152600,2018,Valparaiso University,IN,756,756,0,364,388,4,752,53847,72576.06
216764,2018,West Chester University of Pennsylvania,PA,2777,2777,0,2431,342,4,2773,26114,74655.83
245953,2018,Mid-America Christian University,OK,123,123,0,90,29,4,119,28755,51555.64
237792,2018,Shepherd University,WV,593,593,0,382,207,4,589,17759,62744.63
219602,2018,Austin Peay State University,TN,2009,1967,42,1830,133,4,1963,23931,52472.51
199032,2018,Montreat College,NC,148,148,0,84,60,4,144,40841,61225.9
202170,2018,Columbus College of Art and Design,OH,242,242,0,178,60,4,238,49217,65843.21
201195,2018,Baldwin Wallace University,OH,677,677,0,500,173,4,673,48655,66257.54
180984,2018,Concordia University-Nebraska,NE,356,356,0,171,181,4,352,45672,60450.28
111188,2018,California State University Maritime Academy,CA,216,216,0,171,41,4,212,28149,78248.99
218733,2018,South Carolina State University,SC,541,541,0,450,87,4,537,30015,48129.81
142461,2018,Northwest Nazarene University,ID,278,278,0,131,143,4,274,42068,59470.41
150941,2018,Huntington University,IN,247,243,4,165,74,4,239,38461,63046.08
139861,2018,Georgia College & State University,GA,1483,1482,1,1469,9,4,1478,28707,68382.02
140818,2018,Piedmont College,GA,256,256,0,220,32,4,252,40949,58219.12
161217,2018,University of Maine at Augusta,ME,375,375,0,359,12,4,371,16948,48750.5
210492,2018,Bryn Athyn College of the New Church,PA,64,64,0,46,14,4,60,36254,96737.95
228325,2018,Southwestern Assemblies of God University,TX,303,303,0,177,123,3,300,34268,59789.49
209603,2018,Pacific Northwest College of Art,OR,131,131,0,55,73,3,128,54345,63108.93
137953,2018,Trinity Baptist College,FL,82,81,1,62,16,3,78,22571,58249.91
123572,2018,Sonoma State University,CA,1793,1793,0,1774,16,3,1790,26537,75511.05
157809,2018,Thomas More College,KY,491,491,0,286,202,3,488,42003,64733.74
152390,2018,Saint Mary's College,IN,403,401,2,126,272,3,398,58956,72879.94
220215,2018,Freed-Hardeman University,TN,308,307,1,179,125,3,304,35099,53404.21
199281,2018,University of North Carolina at Pembroke,NC,1233,1205,28,1153,49,3,1202,15952,49520.51
486965,2018,Hussian College-Relativity Campus California,CA,84,38,46,18,17,3,35,61271,64276.692131199976
217305,2018,New England Institute of Technology,RI,525,525,0,216,306,3,522,45601,64106.73
151306,2018,University of Southern Indiana,IN,1644,1644,0,1380,261,3,1641,20146,57279.45
156745,2018,Georgetown College,KY,262,262,0,195,64,3,259,53196,56937.11
219383,2018,University of Sioux Falls,SD,311,311,0,149,159,3,308,30472,57493.05
117557,2018,Lincoln University,CA,5,5,0,2,0,3,2,37686.031269160027,76284.11
181020,2018,Doane University-Arts & Sciences,NE,259,259,0,165,91,3,256,50470,57123.16
162007,2018,Bowie State University,MD,909,905,4,792,110,3,902,22891,77046.6
174127,2018,Minneapolis College of Art and Design,MN,174,173,1,95,75,3,170,53010,70094.27
169327,2018,Cleary University,MI,62,62,0,58,1,3,59,35998,81153.11
173665,2018,Hamline University,MN,538,538,0,426,109,3,535,51984,70958.04
203128,2018,Hiram College,OH,233,232,1,174,55,3,229,50555,63946.73
173452,2018,Martin Luther College,MN,195,195,0,23,169,3,192,27230,64939.16
176406,2018,Tougaloo College,MS,152,152,0,107,42,3,149,22784,44758.77
206835,2018,Oklahoma Wesleyan University,OK,192,186,6,89,94,3,183,40883,51169.37
188058,2018,Northern New Mexico College,NM,173,173,0,164,6,3,170,13960,43101.41
237899,2018,West Virginia State University,WV,327,326,1,264,59,3,323,19144,48790.55
217776,2018,Southern Wesleyan University,SC,215,215,0,148,64,3,212,35949,54696.17
203368,2018,John Carroll University,OH,844,844,0,533,308,3,841,57651,68368.11
219082,2018,Dakota State University,SD,405,405,0,244,158,3,402,22365,52093.19
237367,2018,Fairmont State University,WV,827,819,8,727,90,2,817,17639,42179.08
154022,2018,Ashford University,CA,569,565,4,34,529,2,563,25683,62011.29
449764,2018,Visible Music College,TN,38,31,7,8,21,2,29,32644,64276.692131199976
215947,2018,Seton Hill University,PA,383,376,7,291,83,2,374,50395,54100.65
175005,2018,St Catherine University,MN,411,408,3,336,70,2,406,50794,71786.79
224527,2018,East Texas Baptist University,TX,404,404,0,353,49,2,402,38749,56363.11
173160,2018,Bethel University,MN,619,619,0,486,131,2,617,52723,77038.37
490045,2018,Presbyterian Theological Seminary in America,CA,4,4,0,2,0,2,2,37686.031269160027,64276.692131199976
215132,2018,University of the Sciences,PA,323,323,0,162,159,2,321,43968,72732.06
198543,2018,Fayetteville State University,NC,618,596,22,570,24,2,594,16623,49808.38
171881,2018,Kuyper College,MI,28,28,0,24,2,2,26,33168,68721.86
155089,2018,Friends University,KS,173,173,0,120,51,2,171,39879,60343.56
216542,2018,University of Valley Forge,PA,105,105,0,43,60,2,103,36036,63922.06
229179,2018,Texas Woman's University,TX,1244,1241,3,1220,19,2,1239,19418,69739.2
198756,2018,Johnson C Smith University,NC,350,350,0,187,161,2,348,33444,57295.75
239071,2018,Maranatha Baptist University,WI,153,151,2,33,116,2,149,27793,62743.18
115728,2018,Holy Names University,CA,176,154,22,145,7,2,152,57486,72379.02
212133,2018,Eastern University,PA,423,423,0,264,157,2,421,48828,68457.57
454582,2018,Ottawa University-Online,KS,17,12,5,0,10,2,10,37686.031269160027,64276.692131199976
153320,2018,Faith Baptist Bible College and Theological Seminary,IA,80,80,0,34,44,2,78,28069,57604.15
214272,2018,Neumann University,PA,421,421,0,287,132,2,419,50640,69149.16
235316,2018,Gonzaga University,WA,1196,1184,12,564,618,2,1182,61761,67848.44
225414,2018,University of Houston-Clear Lake,TX,305,292,13,290,0,2,290,25567,67975.01
445708,2018,Johnson & Wales University-Charlotte,NC,487,487,0,179,306,2,485,50200,68856.12
183062,2018,Keene State College,NH,950,947,3,383,562,2,945,28880,75913.18
489937,2018,Piedmont International University,NC,119,119,0,59,58,2,117,22830,64276.692131199976
130493,2018,Southern Connecticut State University,CT,1527,1527,0,1454,71,2,1525,25413,74581.97
225575,2018,Huston-Tillotson University,TX,223,223,0,210,11,2,221,24148,57117.25
112084,2018,San Diego Christian College,CA,67,67,0,48,17,2,65,47755,66943.92
163578,2018,Notre Dame of Maryland University,MD,226,225,1,215,9,1,224,52667,70799.46
170000,2018,Grace Christian University,MI,97,97,0,80,16,1,96,22919,62527.83
215798,2018,Saint Vincent College,PA,417,417,0,310,106,1,416,50140,54143.22
181446,2018,Nebraska Wesleyan University,NE,487,487,0,418,68,1,486,48718,59199.51
240338,2018,Wisconsin Lutheran College,WI,292,292,0,188,103,1,291,43118,69126.34
140340,2018,Herzing University-Atlanta,GA,58,58,0,55,2,1,57,29587,57868.59
211468,2018,Cedar Crest College,PA,207,207,0,145,61,1,206,52279,66384.94
125231,2018,Walden University,MN,127,126,1,2,123,1,125,37686.031269160027,62475.08
198598,2018,Greensboro College,NC,181,181,0,143,37,1,180,30302,63893.94
119605,2018,National University,CA,18,18,0,17,0,1,17,26208,64760.95
121309,2018,Point Loma Nazarene University,CA,657,657,0,509,147,1,656,53045,71269.62
228981,2018,Texas Lutheran University,TX,364,364,0,357,6,1,363,42208,65468.32
161457,2018,University of New England,ME,635,635,0,140,494,1,634,56844,64934.4
163532,2018,Ner Israel Rabbinical College,MD,34,34,0,19,14,1,33,23250,59120.36
120537,2018,Hope International University,CA,91,85,6,75,9,1,84,46231,71774.01
205124,2018,Rabbinical College Telshe,OH,19,19,0,7,11,1,18,20200,60972.72
182458,2018,Sierra Nevada College,NV,83,83,0,18,64,1,82,50040,71252.07
209287,2018,Multnomah University,OR,71,71,0,34,36,1,70,42743,65799
235167,2018,The Evergreen State College,WA,309,309,0,194,114,1,308,24371,63843.36
112394,2018,Cogswell College,CA,98,98,0,89,8,1,97,32382,90231.08
239716,2018,Saint Norbert College,WI,620,620,0,487,132,1,619,51383,71321.9
209409,2018,Northwest Christian University,OR,100,100,0,69,30,1,99,43464,52696.79
118888,2018,Mills College,CA,160,149,11,118,30,1,148,48360,71756.45
157793,2018,Sullivan University,KY,513,513,0,393,119,1,512,28469,55475.64
137272,2018,Saint John Vianney College Seminary,FL,8,8,0,7,0,1,7,40000,64276.692131199976
206862,2018,Southern Nazarene University,OK,290,290,0,162,127,1,289,38327,57571.98
449870,2018,University of the West,CA,18,18,0,16,1,1,17,24236,64276.692131199976
199157,2018,North Carolina Central University,NC,1143,1105,38,860,244,1,1104,24075,57501.19
215743,2018,Saint Francis University,PA,363,333,30,235,97,1,332,54101,55181.27
139153,2018,Beulah Heights University,GA,9,9,0,8,0,1,8,11650,63599.65
141486,2018,Chaminade University of Honolulu,HI,296,293,3,139,153,1,292,38649,72476.63
204936,2018,Otterbein University,OH,579,579,0,506,72,1,578,45773,67882
136215,2018,Nova Southeastern University,FL,1248,1186,62,739,446,1,1185,50429,62876.89
224004,2018,Concordia University Texas,TX,217,217,0,213,3,1,216,47251,72128.5
198507,2018,Elizabeth City State University,NC,418,401,17,299,101,1,400,12754,47337.89
154712,2018,Benedictine College,KS,570,564,6,113,450,1,563,46309,64485.18
141185,2018,Toccoa Falls College,GA,218,218,0,156,61,1,217,37297,59357.86
211431,2018,Carlow University,PA,247,247,0,232,14,1,246,44201,52873.76
213613,2018,Lock Haven University,PA,694,694,0,667,26,1,693,25916,55815.84
203465,2018,Kent State University at Stark,OH,577,577,0,574,2,1,576,12914,59479.84
487603,2018,Northwest University-College of Adult and Professional Studies,WA,95,93,2,40,52,1,92,29793,64276.692131199976
163462,2018,Mount St. Mary's University,MD,549,545,4,307,237,1,544,57867,81781.05
160621,2018,Southern University and A & M College,LA,1342,1340,2,1042,297,1,1339,23592,45854.37
215691,2018,Rosemont College,PA,91,91,0,71,19,1,90,35805,57790.62
198516,2018,Elon University,NC,1698,1660,38,296,1363,1,1659,52587,81102.4
457484,2018,Pacific Rim Christian University,HI,22,20,2,16,3,1,19,23131,64276.692131199976
199759,2018,Southeastern Baptist Theological Seminary,NC,140,131,9,97,33,1,130,18955,64276.692131199976
217420,2018,Rhode Island College,RI,849,849,0,663,185,1,848,17761,61569.63
238430,2018,Cardinal Stritch University,WI,131,130,1,114,15,1,129,44172,64348.07
150534,2018,University of Evansville,IN,498,479,19,295,183,1,478,50986,61532.75
477039,2018,West Coast University-Dallas,TX,16,16,0,16,0,0,16,27991,64276.692131199976
442356,2018,Pennsylvania College of Health Sciences,PA,92,92,0,91,1,0,92,38003,63119.07
207157,2018,Randall University,OK,78,77,1,57,20,0,77,27838,51563.32
433536,2018,Herzing University-Kenner,LA,15,15,0,15,0,0,15,30319,57868.59
116846,2018,American Jewish University,CA,6,6,0,5,1,0,6,37686.031269160027,80280.56
239390,2018,Mount Mary University,WI,145,145,0,135,10,0,145,44284,62361.14
203474,2018,Kent State University at Trumbull,OH,255,254,1,248,6,0,254,13328,59479.84
444787,2018,Nightingale College,UT,24,24,0,8,16,0,24,37686.031269160027,60498.27
430184,2018,Strayer University-Maryland,MD,221,221,0,196,25,0,221,28284,64276.692131199976
155812,2018,University of Saint Mary,KS,134,134,0,68,66,0,134,42175,62613.14
460349,2018,Johnson & Wales University-Online,RI,30,28,2,6,22,0,28,25224,64276.692131199976
213774,2018,Manor College,PA,214,202,12,193,9,0,202,25964,60787.72
230056,2018,Broadview University-West Jordan,UT,19,19,0,18,1,0,19,27859,70004.7
443599,2018,American College of Healthcare Sciences,OR,6,6,0,0,6,0,6,24887,64276.692131199976
211477,2018,Central Penn College,PA,106,106,0,100,6,0,106,27042,56698.35
201061,2018,Art Academy of Cincinnati,OH,63,63,0,39,24,0,63,44864,69050.69
152336,2018,University of Saint Francis-Fort Wayne,IN,347,347,0,306,41,0,347,40759,63802.5
119775,2018,Newschool of Architecture and Design,CA,22,21,1,19,2,0,21,50284,67862.5
227331,2018,Our Lady of the Lake University,TX,374,368,6,364,4,0,368,40753,52505.04
124487,2018,Epic Bible College,CA,10,10,0,10,0,0,10,37686.031269160027,63747.56
199971,2018,Carolina Christian College,NC,16,16,0,11,5,0,16,14600,48527.11
156471,2018,Galen College of Nursing-Louisville,KY,46,46,0,38,8,0,46,37686.031269160027,54499.36
211556,2018,Chatham University,PA,282,263,19,202,61,0,263,52968,56097.18
133465,2018,South University-West Palm Beach,FL,10,10,0,9,1,0,10,28179,55764.27
230366,2018,Eagle Gate College-Murray,UT,40,40,0,39,1,0,40,22097,64280.58
386472,2018,Herzing University-Winter Park,FL,42,42,0,41,1,0,42,30319,57868.59
447050,2018,United States University,CA,2,2,0,0,2,0,2,20187,63190.95
114813,2018,Fresno Pacific University,CA,235,235,0,223,12,0,235,43317,53503.12
117104,2018,Life Pacific College,CA,101,101,0,67,34,0,101,29158,65850.07
214069,2018,Misericordia University,PA,415,415,0,276,139,0,415,48844,56588.57
214148,2018,Moore College of Art and Design,PA,98,98,0,51,47,0,98,60910,70661.87
183257,2018,Granite State College,NH,68,66,2,46,20,0,66,18834,59743.94
215114,2018,Cairn University-Langhorne,PA,186,184,2,81,103,0,184,41762,69912.01
109785,2018,Azusa Pacific University,CA,1005,970,35,786,184,0,970,56802,73950.46
180878,2018,Bryan College of Health Sciences,NE,63,63,0,63,0,0,63,30615,58151.07
202806,2018,Franklin University,OH,83,83,0,76,7,0,83,23956,59424.91
485546,2018,California Intercontinental University,CA,61,61,0,32,29,0,61,37686.031269160027,64276.692131199976
216852,2018,Widener University,PA,775,775,0,461,314,0,775,62831,69397.52
201104,2018,Ashland University,OH,602,586,16,531,55,0,586,33775,64491.65
132408,2018,The Baptist College of Florida,FL,33,33,0,28,5,0,33,19926,50305.97
408844,2018,Florida National University-Main Campus,FL,514,511,3,510,1,0,511,28378,51661.46
159009,2018,Grambling State University,LA,923,899,24,517,382,0,899,24332,44602.47
225201,2018,Hallmark University,TX,80,80,0,79,1,0,80,37686.031269160027,55040.41
458885,2018,Strayer University-Arkansas,AR,45,45,0,44,1,0,45,37686.031269160027,64276.692131199976
457402,2018,University of Fort Lauderdale,FL,33,4,29,3,1,0,4,37686.031269160027,64276.692131199976
202763,2018,The University of Findlay,OH,560,560,0,422,138,0,560,47032,61890.4
119173,2018,Mount Saint Mary's University,CA,405,404,1,392,12,0,404,57689,59943.9
199999,2018,Winston-Salem State University,NC,935,925,10,816,109,0,925,20382,54716.68
482459,2018,DeVry University-Florida,FL,15,15,0,14,1,0,15,37295,64276.692131199976
180814,2018,Bellevue University,NE,32,32,0,24,8,0,32,22961,63424.91
224226,2018,Dallas Baptist University,TX,548,548,0,504,44,0,548,42855,71641.68
150172,2018,Calumet College of Saint Joseph,IN,116,102,14,79,23,0,102,26540,57573.54
414878,2018,Trine University-Regional/Non-Traditional Campuses,IN,3,3,0,3,0,0,3,37686.031269160027,60275.33
177038,2018,Cleveland University-Kansas City,KS,2,2,0,1,1,0,2,37686.031269160027,61070.83
489779,2018,Purdue University Global-Indianapolis,IN,81,81,0,78,3,0,81,37686.031269160027,64276.692131199976
459842,2018,Herzing University-Kenosha,WI,25,25,0,11,14,0,25,28529,64276.692131199976
181604,2018,College of Saint Mary,NE,119,119,0,91,28,0,119,31250,62625.82
441636,2018,American Institute of Alternative Medicine,OH,18,18,0,18,0,0,18,31136,58848.36
458210,2018,West Coast University-Orange County,CA,17,17,0,17,0,0,17,41865,64276.692131199976
484710,2018,University of Phoenix-Nevada,NV,1,1,0,1,0,0,1,37686.031269160027,64276.692131199976
135364,2018,Luther Rice College & Seminary,GA,8,8,0,6,2,0,8,37686.031269160027,65125.89
378576,2018,Pacific College of Oriental Medicine-San Diego,CA,37,37,0,35,2,0,37,32037,64347.54
453163,2018,Strayer University-North Carolina,NC,465,465,0,431,34,0,465,37686.031269160027,64276.692131199976
139719,2018,Fort Valley State University,GA,480,480,0,439,41,0,480,20264,53364.82
384412,2018,University of the Potomac-Washington DC Campus,DC,30,15,15,10,5,0,15,24964,78717.65
200013,2018,Rasmussen College-North Dakota,ND,24,24,0,17,7,0,24,23022,52350.64
150677,2018,Grace College and Theological Seminary,IN,320,320,0,197,123,0,320,36725,63627.14
433004,2018,American University of Health Sciences,CA,2,2,0,2,0,0,2,35965,58092.74
159656,2018,Loyola University New Orleans,LA,789,768,21,310,458,0,768,54417,67759.61
446561,2018,Stanbridge University,CA,282,164,118,164,0,0,164,37686.031269160027,90341.71
488031,2018,Abraham Lincoln University,CA,8,8,0,3,5,0,8,37686.031269160027,64276.692131199976
402776,2018,Southwest University of Visual Arts-Albuquerque,NM,9,9,0,9,0,0,9,37686.031269160027,64276.692131199976
214883,2018,Peirce College,PA,44,44,0,39,5,0,44,18260,49493.53
139579,2018,South University-Savannah,GA,13,13,0,13,0,0,13,30800,55764.27
484631,2018,University of Phoenix-California,CA,15,15,0,15,0,0,15,18184,64276.692131199976
456621,2018,Strayer University-West Virginia,WV,25,25,0,23,2,0,25,37686.031269160027,64276.692131199976
401223,2018,World Mission University,CA,29,29,0,22,7,0,29,22025,62541
447263,2018,AmeriTech College-Draper,UT,63,63,0,63,0,0,63,26144,62933.79
461528,2018,Grace College of Divinity,NC,9,9,0,6,3,0,9,14977,64276.692131199976
238193,2018,Alverno College,WI,187,187,0,169,18,0,187,40724,58784.16
130989,2018,Goldey-Beacom College,DE,151,151,0,94,57,0,151,39197,70369.91
459851,2018,Herzing University-Brookfield,WI,56,56,0,37,19,0,56,29268,64276.692131199976
475608,2018,Criswell College,TX,13,13,0,13,0,0,13,23142,64276.692131199976
212832,2018,Gwynedd Mercy University,PA,276,274,2,244,30,0,274,47646,72929.99
151810,2018,Martin University,IN,22,22,0,22,0,0,22,23393,51133.47
251312,2018,South University-Columbia,SC,20,20,0,20,0,0,20,28397,55764.27
199607,2018,Salem College,NC,103,100,3,75,25,0,100,44461,59058
117575,2018,Southern California Seminary,CA,1,1,0,1,0,0,1,37686.031269160027,61547.27
484756,2018,University of Phoenix-Texas,TX,2,2,0,2,0,0,2,16367,64276.692131199976
114123,2018,Empire College,CA,151,133,18,133,0,0,133,37686.031269160027,70826.06
450571,2018,Rasmussen College-Wisconsin,WI,36,36,0,36,0,0,36,23497,64276.692131199976
488068,2018,Huntington University of Health Sciences,TN,3,3,0,1,2,0,3,27091,64276.692131199976
160074,2018,Franciscan Missionaries of Our Lady University,LA,83,72,11,72,0,0,72,26751,54007.12
458973,2018,Strayer University-Texas,TX,196,196,0,194,2,0,196,28284,64276.692131199976
433420,2018,California Aeronautical University,CA,54,54,0,49,5,0,54,42622,65732.08
120184,2018,Notre Dame de Namur University,CA,179,175,4,149,26,0,175,37686.031269160027,89560.16
216366,2018,Thomas Jefferson University,PA,594,587,7,337,250,0,587,60290,66565.04
238263,2018,Madison Area Technical College,WI,1608,1559,49,1526,33,0,1559,14210,64533.76
123651,2018,Vanguard University of Southern California,CA,461,461,0,410,51,0,461,48086,75891.29
120768,2018,Pacific Oaks College,CA,24,24,0,20,4,0,24,37686.031269160027,60596.02
226587,2018,McMurry University,TX,221,221,0,217,4,0,221,41764,52571.87
458955,2018,Strayer University-Mississippi,MS,56,56,0,52,4,0,56,37686.031269160027,64276.692131199976
480781,2018,California Miramar University,CA,7,7,0,3,4,0,7,20578,64276.692131199976
217934,2018,Columbia College,SC,161,161,0,147,14,0,161,33178,56463.66
443766,2018,Strayer University-Tennessee,TN,328,328,0,259,69,0,328,28284,64276.692131199976
131113,2018,Wilmington University,DE,612,610,2,373,237,0,610,18524,66924.87
174154,2018,Herzing University-Minneapolis,MN,36,36,0,35,1,0,36,28018,71504.15
484905,2018,University of North Texas at Dallas,TX,365,365,0,361,4,0,365,18930,64276.692131199976
102669,2018,Alaska Pacific University,AK,41,39,2,23,16,0,39,34350,70542.98
220181,2018,Fisk University,TN,278,261,17,53,208,0,261,37482,55965.03
211352,2018,Cabrini University,PA,442,442,0,343,99,0,442,46293,77292.03
482431,2018,DeVry University-California,CA,51,51,0,49,2,0,51,35697,64276.692131199976
213783,2018,Mansfield University of Pennsylvania,PA,327,327,0,282,45,0,327,24278,51271.33
451103,2018,Miami Regional College,FL,157,157,0,157,0,0,157,37686.031269160027,64276.692131199976
134510,2018,Hobe Sound Bible College,FL,51,40,11,12,28,0,40,14488,50360.1
213303,2018,Keystone College,PA,335,335,0,277,58,0,335,39200,51740.58
216694,2018,Waynesburg University,PA,326,326,0,258,68,0,326,37431,52961.26
203960,2018,Mercy College of Ohio,OH,66,66,0,50,16,0,66,22784,58075.98
458919,2018,Strayer University-Georgia,GA,667,667,0,615,52,0,667,28284,64276.692131199976
204200,2018,Mount Saint Joseph University,OH,318,318,0,210,108,0,318,39248,64120.45
159939,2018,University of New Orleans,LA,1019,1001,18,930,71,0,1001,20864,51940.24
210146,2018,Southern Oregon University,OR,634,615,19,339,276,0,615,17755,54749.32
137564,2018,Southeastern University,FL,1460,1434,26,722,712,0,1434,39276,60101.07
207582,2018,Oral Roberts University,OK,573,512,61,215,297,0,512,44006,63453.08
133872,2018,AdventHealth University,FL,94,94,0,84,10,0,94,33648,60028.37
219639,2018,Baptist Memorial College of Health Sciences,TN,105,105,0,87,18,0,105,20485,61604.19
449898,2018,South University-Tampa,FL,23,23,0,22,1,0,23,28397,64276.692131199976
240392,2018,Herzing University-Madison,WI,121,121,0,43,78,0,121,29140,60281.46
482617,2018,DeVry University-Tennessee,TN,2,2,0,2,0,0,2,37460,64276.692131199976
128780,2018,Charter Oak State College,CT,47,47,0,41,6,0,47,16369,63157.4
162061,2018,Capitol Technology University,MD,84,84,0,62,22,0,84,40538,73053.75
216807,2018,Westminster College,PA,348,347,1,250,97,0,347,49932,56138.86
142294,2018,The College of Idaho,ID,286,230,56,153,77,0,230,45607,57741.96
113582,2018,Design Institute of San Diego,CA,7,7,0,4,3,0,7,42928,71383.01
474863,2018,Los Angeles Pacific University,CA,49,49,0,42,7,0,49,26995,64276.692131199976
150604,2018,Franklin College,IN,272,272,0,248,24,0,272,46533,61682.88
201964,2018,Ohio Christian University,OH,345,345,0,192,153,0,345,32568,54881.86
459727,2018,Touro University Worldwide,CA,31,30,1,15,15,0,30,27335,64276.692131199976
156125,2018,Wichita State University,KS,1714,1686,28,1348,338,0,1686,20418,60078.99
223117,2018,Baptist Missionary Association Theological Seminary,TX,3,3,0,1,2,0,3,37686.031269160027,48842.7
129534,2018,Holy Apostles College and Seminary,CT,11,11,0,6,5,0,11,37686.031269160027,64276.692131199976
216357,2018,Thiel College,PA,236,236,0,138,98,0,236,48566,54604.75
243823,2018,Parker University,TX,140,140,0,133,7,0,140,31420,69941.77
217059,2018,York College of Pennsylvania,PA,979,976,3,620,356,0,976,32801,73378.65
111966,2018,Charles R Drew University of Medicine and Science,CA,27,27,0,25,2,0,27,33171,55906.67
130314,2018,University of Saint Joseph,CT,218,218,0,201,17,0,218,50959,74607
372073,2018,Fremont College,CA,31,31,0,28,3,0,31,37686.031269160027,62794.03
151786,2018,Marian University,IN,425,419,6,362,57,0,419,49112,65206.92
457086,2018,Homestead Schools,CA,8,8,0,8,0,0,8,37686.031269160027,64276.692131199976
211088,2018,Arcadia University,PA,474,474,0,267,207,0,474,59684,72830.78
206154,2018,Tri-State Bible College,OH,2,2,0,0,2,0,2,14768,44613.4
169363,2018,Concordia University-Ann Arbor,MI,234,232,2,182,50,0,232,45348,70459.21
475398,2018,Catholic Distance University,WV,2,2,0,0,2,0,2,37686.031269160027,64276.692131199976
181297,2018,Nebraska Methodist College of Nursing & Allied Health,NE,51,51,0,41,10,0,51,31690,66507.51
211583,2018,Chestnut Hill College,PA,167,162,5,102,60,0,162,54599,61319.18
172033,2018,Sacred Heart Major Seminary,MI,10,10,0,10,0,0,10,36882,73787.59
482635,2018,DeVry University-Texas,TX,8,8,0,8,0,0,8,33151,64276.692131199976
210401,2018,Willamette University,OR,390,386,4,101,285,0,386,66416,68135.42
160904,2018,Xavier University of Louisiana,LA,865,843,22,319,524,0,843,36391,55657.89
122834,2018,Santa Barbara Business College-Bakersfield,CA,23,23,0,23,0,0,23,20065,46373.44
209241,2018,Mount Angel Seminary,OR,3,3,0,2,1,0,3,39700,59323.69
413413,2018,Capella University,MN,116,109,7,1,108,0,109,21167,64334.8
461795,2018,North American University,TX,60,60,0,56,4,0,60,20685,64276.692131199976
131876,2018,Trinity Washington University,DC,222,222,0,106,116,0,222,32710,60221.46
222877,2018,Arlington Baptist University,TX,39,38,1,37,1,0,38,25381,61756.37
211024,2018,Clarks Summit University,PA,106,95,11,48,47,0,95,33826,62401.75
457299,2018,Angeles College,CA,25,25,0,25,0,0,25,37686.031269160027,64276.692131199976
213011,2018,Immaculata University,PA,193,193,0,141,52,0,193,44036,74355.43
157100,2018,Kentucky Christian University,KY,155,154,1,76,78,0,154,34496,53919.37
238616,2018,Concordia University-Wisconsin,WI,571,570,1,393,177,0,570,45936,64715.84
115773,2018,Humphreys University-Stockton and Modesto Campuses,CA,16,16,0,16,0,0,16,21249,54713.65
212452,2018,Faith Theological Seminary,MD,2,2,0,2,0,0,2,37686.031269160027,64276.692131199976
438151,2018,Stevens-Henager College,UT,14,14,0,14,0,0,14,31726,60842.94
488448,2018,Seattle Film Institute,WA,7,7,0,5,2,0,7,46181,64276.692131199976
449038,2018,Strayer University-Florida,FL,117,117,0,111,6,0,117,28284,64276.692131199976
443784,2018,Strayer University-Pennsylvania,PA,196,196,0,183,13,0,196,28284,64276.692131199976
204006,2018,Miami University-Hamilton,OH,529,529,0,514,15,0,529,16237,72182.76
131803,2018,Strayer University-District of Columbia,DC,61,61,0,41,20,0,61,37686.031269160027,66472.61
213400,2018,Lancaster Bible College,PA,190,187,3,133,54,0,187,36544,64787.49
217624,2018,Allen University,SC,271,266,5,173,93,0,266,24695,49460.71
220631,2018,Lincoln Memorial University,TN,292,274,18,159,115,0,274,36365,43510.38
136172,2018,University of North Florida,FL,2474,2438,36,2365,73,0,2438,19469,62628.24
180832,2018,Clarkson College,NE,19,19,0,16,3,0,19,24917,61065.74
203085,2018,Heidelberg University,OH,329,327,2,265,62,0,327,44381,61648.4
216047,2018,Saint Charles Borromeo Seminary-Overbrook,PA,12,12,0,9,3,0,12,41324,58077.31
490081,2018,America Evangelical University,CA,21,12,9,12,0,0,12,11420,64276.692131199976
218238,2018,Limestone College,SC,387,369,18,231,138,0,369,42137,53494.1
160065,2018,University of Holy Cross,LA,120,120,0,118,2,0,120,23715,52742.13
482608,2018,DeVry University-Pennsylvania,PA,7,7,0,5,2,0,7,34602,64276.692131199976
490805,2018,Purdue University Northwest,IN,1172,1172,0,1068,104,0,1172,17408,64276.692131199976
155681,2018,Pittsburg State University,KS,962,959,3,630,329,0,959,18657,50242.27
490230,2018,Reformed University,GA,11,11,0,11,0,0,11,21060,64276.692131199976
211981,2018,Delaware Valley University,PA,447,447,0,257,190,0,447,56828,74767.83
161873,2018,University of Baltimore,MD,76,75,1,73,2,0,75,24521,65721.01
482468,2018,DeVry University-Georgia,GA,22,22,0,22,0,0,22,34215,64276.692131199976
220552,2018,South College,TN,433,433,0,368,65,0,433,27758,48993.08
465812,2018,Independence University,UT,7186,7186,0,171,7015,0,7186,31805,64276.692131199976
205027,2018,Pontifical College Josephinum,OH,19,17,2,4,13,0,17,43542,56364.42
225399,2018,Houston Baptist University,TX,531,526,5,507,19,0,526,43638,72476.33
219046,2018,Black Hills State University,SD,490,483,7,337,146,0,483,20937,49477.45
438586,2018,American InterContinental University-Atlanta,GA,138,138,0,138,0,0,138,21048,58772.86
206279,2018,Union Institute & University,OH,5,5,0,1,4,0,5,31656,59714.64
210304,2018,Warner Pacific University,OR,66,66,0,45,21,0,66,32176,63798.34
433387,2018,Western Governors University,UT,206,206,0,19,187,0,206,13790,62039.21
422695,2018,Pacific College,CA,6,6,0,6,0,0,6,37686.031269160027,73126.5
445133,2018,American InterContinental University-Houston,TX,36,36,0,36,0,0,36,21745,58772.86
154350,2018,Simpson College,IA,360,360,0,293,67,0,360,53845,60274.33
262086,2018,Brandman University,CA,70,69,1,27,42,0,69,32504,73437.32
128498,2018,Albertus Magnus College,CT,169,169,0,156,13,0,169,49375,65065.75
224554,2018,Texas A & M University-Commerce,TX,1075,1075,0,1058,17,0,1075,22575,57562.14
475121,2018,South University–Savannah Online,GA,356,355,1,41,314,0,355,27732,64276.692131199976
135610,2018,Trinity International University-Florida,FL,7,7,0,7,0,0,7,37686.031269160027,72368.27
440828,2018,Oregon State University-Cascades Campus,OR,101,101,0,88,13,0,101,25945,60312.67
117672,2018,Southern California University of Health Sciences,CA,2,2,0,2,0,0,2,37686.031269160027,64276.692131199976
482574,2018,DeVry University-Ohio,OH,28,28,0,28,0,0,28,34949,64276.692131199976
157757,2018,Spalding University,KY,185,184,1,146,38,0,184,38163,55916.29
110468,2018,Alliant International University-San Diego,CA,1,1,0,1,0,0,1,37686.031269160027,71211.32
482547,2018,DeVry University-Nevada,NV,2,2,0,1,1,0,2,34274,64276.692131199976
234915,2018,City University of Seattle,WA,15,15,0,11,4,0,15,37686.031269160027,67486.66
461032,2018,Carolina College of Biblical Studies,NC,24,24,0,23,1,0,24,21340,64276.692131199976
247773,2018,Yeshiva Gedolah of Greater Detroit,MI,15,15,0,9,6,0,15,15067,63218.7
174437,2018,North Central University,MN,220,220,0,127,93,0,220,37644,65000.36
157058,2018,Kentucky State University,KY,301,301,0,145,156,0,301,16885,51636.62
205443,2018,Shawnee State University,OH,616,612,4,530,82,0,612,16327,43961.17
212984,2018,Holy Family University,PA,354,323,31,294,29,0,323,37020,61868.46
204176,2018,Mount Carmel College of Nursing,OH,69,69,0,69,0,0,69,21615,68565.22
481058,2018,Grace Mission University,CA,2,2,0,2,0,0,2,18621,64276.692131199976
459994,2018,Strayer University-Global Region,DC,724,724,0,0,724,0,724,28284,64276.692131199976
158477,2018,Centenary College of Louisiana,LA,169,168,1,87,81,0,168,55300,58549.24
123952,2018,Southern California Institute of Architecture,CA,29,14,15,10,4,0,14,70734,66525.34
480985,2018,Midwives College of Utah,UT,5,5,0,1,4,0,5,24516,64276.692131199976
442930,2018,University of Antelope Valley,CA,153,153,0,144,9,0,153,37686.031269160027,57306.38
110653,2019,University of California-Irvine,CA,6069,6066,3,4691,137,1238,4828,34355,78085.65
110680,2019,University of California-San Diego,CA,6023,6019,4,4382,640,997,5022,33240,76397.62
110705,2019,University of California-Santa Barbara,CA,4935,4932,3,3678,363,891,4041,36492,73046.19
110635,2019,University of California-Berkeley,CA,6454,6452,2,4647,933,872,5580,39016,77601.85
204796,2019,Ohio State University-Main Campus,OH,7716,7707,9,5155,1906,646,7061,27202,65208.79
240444,2019,University of Wisconsin-Madison,WI,7550,7540,10,3763,3140,637,6903,26393,71185.17
110662,2019,University of California-Los Angeles,CA,5919,5915,4,4438,915,562,5353,35497,72896.84
139940,2019,Georgia State University,GA,5064,5059,5,3125,1421,513,4546,27206,72190.32
123961,2019,University of Southern California,CA,3165,3164,1,1264,1396,504,2660,77362,76787.41
174066,2019,University of Minnesota-Twin Cities,MN,6278,6258,20,4121,1674,463,5795,27654,70741.62
134130,2019,University of Florida,FL,6526,6483,43,5190,881,412,6071,21151,60120.16
140951,2019,Savannah College of Art and Design,GA,2769,2732,37,402,1934,396,2336,58367,71588.69
131469,2019,George Washington University,DC,2619,2559,60,48,2135,376,2183,74023,85677.46
129020,2019,University of Connecticut,CT,3603,3602,1,2438,793,371,3231,33896,80999.86
211440,2019,Carnegie Mellon University,PA,1585,1583,2,137,1124,322,1261,74489,81652.61
215062,2019,University of Pennsylvania,PA,2389,2299,90,411,1574,314,1985,78186,78252
217156,2019,Brown University,RI,1660,1656,4,48,1350,258,1398,77490,79027.35
228778,2019,The University of Texas at Austin,TX,8170,8170,0,7372,545,253,7917,27397,72284.1
137351,2019,University of South Florida-Main Campus,FL,5139,5090,49,4384,457,249,4841,21134,58397.57
139658,2019,Emory University,GA,1374,1374,0,178,950,246,1128,72604,80509.92
212054,2019,Drexel University,PA,3178,3138,40,1386,1515,237,2901,69397,74533.27
221999,2019,Vanderbilt University,TN,1604,1594,10,151,1209,234,1360,73148,76279.78
230764,2019,University of Utah,UT,4249,4181,68,2541,1414,226,3955,20303,69474.52
204024,2019,Miami University-Oxford,OH,4309,4301,8,2535,1548,218,4083,33805,72182.76
201645,2019,Case Western Reserve University,OH,1357,1357,0,253,894,210,1147,69526,69873.4
228796,2019,The University of Texas at El Paso,TX,3616,3613,3,3331,76,206,3407,18291,46777.52
122612,2019,University of San Francisco,CA,1293,1280,13,703,376,201,1079,69987,82472.56
227216,2019,University of North Texas,TX,5613,5609,4,5163,252,194,5415,23770,72891.36
130794,2019,Yale University,CT,1550,1550,0,96,1269,185,1365,76645,75345.96
117946,2019,Loyola Marymount University,CA,1467,1461,6,820,463,178,1283,70235,78631.93
152080,2019,University of Notre Dame,IN,2051,2051,0,156,1720,175,1876,74172,76710.92
201885,2019,University of Cincinnati-Main Campus,OH,5480,5475,5,4347,955,173,5302,26892,64722.83
215293,2019,University of Pittsburgh-Pittsburgh Campus,PA,4026,4004,22,2395,1436,173,3831,33964,58452.18
181464,2019,University of Nebraska-Lincoln,NE,4775,4718,57,3352,1197,169,4549,24400,60976.73
228769,2019,The University of Texas at Arlington,TX,3707,3707,0,3512,42,153,3554,23902,66876.51
486840,2019,Kennesaw State University,GA,6533,6499,34,5438,908,153,6346,25059,64276.692131199976
209551,2019,University of Oregon,OR,4525,4521,4,2069,2301,151,4370,27717,62294.9
490133,2019,Westcliff University,CA,215,215,0,56,10,149,66,22466,64276.692131199976
199847,2019,Wake Forest University,NC,1360,1358,2,243,974,141,1217,74135,80539.14
225511,2019,University of Houston,TX,5680,5670,10,5400,131,139,5531,23361,68874.27
108232,2019,Academy of Art University,CA,803,798,5,289,371,138,660,43976,74015.06
131496,2019,Georgetown University,DC,1582,1580,2,28,1416,136,1444,76280,82187.36
163295,2019,Maryland Institute College of Art,MD,405,405,0,53,216,136,269,66413,80395.11
122409,2019,San Diego State University,CA,5275,5275,0,4255,886,134,5141,23367,68953.33
227757,2019,Rice University,TX,961,960,1,382,447,131,829,67102,77707.58
199193,2019,North Carolina State University at Raleigh,NC,4873,4861,12,4242,493,126,4735,24202,64180.75
110671,2019,University of California-Riverside,CA,4769,4769,0,4619,29,121,4648,30561,68292.12
223232,2019,Baylor University,TX,3307,3302,5,2006,1182,114,3188,65222,73627.32
137847,2019,The University of Tampa,FL,2184,2177,7,362,1702,113,2064,46341,71934.52
110583,2019,California State University-Long Beach,CA,5161,5161,0,4966,93,102,5059,19846,66954.9
229115,2019,Texas Tech University,TX,6145,6145,0,5708,346,91,6054,23191,65284.89
228787,2019,The University of Texas at Dallas,TX,4073,4073,0,3745,240,88,3985,27120,79361.13
122597,2019,San Francisco State University,CA,3694,3694,0,3558,51,85,3609,24513,77495.51
111948,2019,Chapman University,CA,1768,1768,0,1124,562,82,1686,74336,73437.32
228246,2019,Southern Methodist University,TX,1544,1526,18,568,878,80,1446,76346,82038.46
183026,2019,Southern New Hampshire University,NH,10485,10377,108,775,9523,79,10298,50505,71986.54
228875,2019,Texas Christian University,TX,2159,2151,8,926,1147,78,2073,68072,76266.48
218663,2019,University of South Carolina-Columbia,SC,6286,6262,24,3255,2929,78,6184,28602,62188.24
163286,2019,University of Maryland-College Park,MD,5340,5340,0,3806,1458,76,5264,27343,90010.73
122755,2019,San Jose State University,CA,3964,3964,0,3853,36,75,3889,25747,88589.14
228723,2019,Texas A & M University-College Station,TX,10613,10613,0,10046,493,74,10539,29920,67194.13
207388,2019,Oklahoma State University-Main Campus,OK,4183,4179,4,2766,1339,74,4105,23906,55237.91
130590,2019,Trinity College,CT,580,580,0,86,420,74,506,76850,81265.21
110608,2019,California State University-Northridge,CA,4792,4792,0,4661,59,72,4720,19794,64055.44
181394,2019,University of Nebraska at Omaha,NE,2067,2063,4,1830,161,72,1991,19797,66043.01
151111,2019,Indiana University-Purdue University-Indianapolis,IN,4295,4287,8,3979,236,72,4215,21127,64749.24
230959,2019,Middlebury College,VT,605,580,25,21,488,71,509,74248,77169.17
182281,2019,University of Nevada-Las Vegas,NV,4465,4448,17,3579,800,69,4379,18756,70070.97
202480,2019,University of Dayton,OH,2035,2034,1,1017,948,69,1965,60900,75690.27
187985,2019,University of New Mexico-Main Campus,NM,2594,2585,9,2149,369,67,2518,19351,49538.77
129525,2019,University of Hartford,CT,1234,1231,3,514,650,67,1164,57475,82221.8
121150,2019,Pepperdine University,CA,726,716,10,340,310,66,650,75312,79068.51
131520,2019,Howard University,DC,1925,1910,15,16,1828,66,1844,45971,66680.2
159391,2019,Louisiana State University and Agricultural & Mechanical College,LA,6132,6124,8,4636,1423,65,6059,32724,57504.74
211291,2019,Bucknell University,PA,964,964,0,198,702,64,900,75400,84046.3
120403,2019,Otis College of Art and Design,CA,274,250,24,125,62,63,187,66695,73811.67
169798,2019,Eastern Michigan University,MI,2152,2151,1,1794,294,63,2088,24994,69989
112260,2019,Claremont McKenna College,CA,328,328,0,112,154,62,266,76475,82855.72
136950,2019,Rollins College,FL,556,556,0,287,207,62,494,66805,69363.5
157085,2019,University of Kentucky,KY,5348,5345,3,3291,1996,58,5287,30178,59287.73
207582,2019,Oral Roberts University,OK,554,554,0,230,266,58,496,44006,63453.08
229027,2019,The University of Texas at San Antonio,TX,4599,4599,0,4462,80,57,4542,18923,63798.29
220978,2019,Middle Tennessee State University,TN,3312,3312,0,2900,355,57,3255,21241,60340.43
201441,2019,Bowling Green State University-Main Campus,OH,3389,3389,0,3022,310,57,3332,24529,63749.73
156365,2019,Campbellsville University,KY,664,662,2,535,70,57,605,38502,47586.61
236939,2019,Washington State University,WA,4812,4750,62,3766,927,57,4693,26068,63710
122931,2019,Santa Clara University,CA,1391,1345,46,718,573,54,1291,74297,93581.09
110565,2019,California State University-Fullerton,CA,4778,4778,0,4710,14,54,4724,17791,73036.4
114354,2019,FIDM-Fashion Institute of Design & Merchandising-Los Angeles,CA,426,426,0,198,175,53,373,51281,73476
163268,2019,University of Maryland-Baltimore County,MD,1701,1695,6,1542,100,53,1642,25997,83010.29
217165,2019,Bryant University,RI,854,854,0,90,712,52,802,62855,80219.8
199139,2019,University of North Carolina at Charlotte,NC,3653,3619,34,3360,207,52,3567,23478,65762.02
240453,2019,University of Wisconsin-Milwaukee,WI,3761,3761,0,3246,463,52,3709,21984,65921.14
482680,2019,University of North Georgia,GA,4157,4156,1,4008,98,50,4106,16816,64276.692131199976
139931,2019,Georgia Southern University,GA,4253,4250,3,3942,258,50,4200,22608,62772.56
399911,2019,Soka University of America,CA,108,108,0,28,31,49,59,50968,79623.38
220862,2019,University of Memphis,TN,2683,2683,0,2248,386,49,2634,24139,58823.6
157447,2019,Northern Kentucky University,KY,1950,1948,2,1335,565,48,1900,17869,63568.77
139959,2019,University of Georgia,GA,5499,5492,7,4508,936,48,5444,27329,71225.06
217235,2019,Johnson & Wales University-Providence,RI,1494,1494,0,245,1201,48,1446,51167,68856.12
209922,2019,Reed College,OR,394,394,0,30,317,47,347,75586,71777.6
110617,2019,California State University-Sacramento,CA,4160,4160,0,4056,57,47,4113,21576,65686.13
216597,2019,Villanova University,PA,1695,1695,0,304,1345,46,1649,73042,90091.77
130226,2019,Quinnipiac University,CT,1552,1552,0,419,1087,46,1506,66237,87986.1
110529,2019,California State Polytechnic University-Pomona,CA,3694,3694,0,3593,56,45,3649,22365,68064.96
169716,2019,University of Detroit Mercy,MI,530,530,0,461,24,45,485,38440,64142.33
482158,2019,Middle Georgia State University,GA,1442,1441,1,1231,166,44,1397,15822,64276.692131199976
200004,2019,Western Carolina University,NC,2107,2089,18,1782,263,44,2045,18462,56230.92
141574,2019,University of Hawaii at Manoa,HI,2020,2009,11,1177,789,43,1966,23405,71646.27
120254,2019,Occidental College,CA,562,561,1,216,303,42,519,76600,75275.66
110097,2019,Biola University,CA,907,907,0,608,257,42,865,58012,75484.4
129242,2019,Fairfield University,CT,1176,1176,0,230,904,42,1134,67080,93458.99
188030,2019,New Mexico State University-Main Campus,NM,2178,2162,16,1554,568,40,2122,19760,43867.23
228802,2019,The University of Texas at Tyler,TX,843,843,0,797,7,39,804,20730,53622.93
110556,2019,California State University-Fresno,CA,3334,3334,0,3262,34,38,3296,17683,53295.09
134945,2019,Jacksonville University,FL,657,652,5,338,276,38,614,54991,63671.93
122436,2019,University of San Diego,CA,1142,1125,17,595,493,37,1088,70440,79883.39
132903,2019,University of Central Florida,FL,7323,7302,21,6729,537,36,7266,21309,62518.63
240426,2019,University of Wisconsin-Superior,WI,327,327,0,164,128,35,292,18731,53835.5
229267,2019,Trinity University,TX,646,646,0,477,135,34,612,60664,78650.29
201654,2019,Cedarville University,OH,995,995,0,366,595,34,961,42318,67472.37
131399,2019,University of the District of Columbia,DC,651,643,8,531,78,34,609,22638,51576.54
224147,2019,Texas A & M University-Corpus Christi,TX,1915,1915,0,1838,43,34,1881,22459,54287.8
239105,2019,Marquette University,WI,1977,1977,0,683,1261,33,1944,59725,75591.25
230816,2019,Bennington College,VT,179,179,0,12,134,33,146,75972,77879.63
227845,2019,Saint Edward's University,TX,697,688,9,561,95,32,656,61707,71197.81
207971,2019,University of Tulsa,OK,831,818,13,408,378,32,786,58637,62928.78
107141,2019,John Brown University,AR,319,318,1,127,159,32,286,40774,56884.69
174914,2019,University of St Thomas,MN,1579,1575,4,1272,272,31,1544,57785,76939.14
238430,2019,Cardinal Stritch University,WI,139,139,0,77,31,31,108,44172,64348.07
237066,2019,Whitworth University,WA,683,683,0,448,204,31,652,60359,63739.65
204857,2019,Ohio University-Main Campus,OH,3679,3678,1,3190,457,31,3647,29534,59563.35
156082,2019,Washburn University,KS,788,785,3,678,77,30,755,20011,57541.98
163204,2019,University of Maryland Global Campus,MD,646,640,6,210,400,30,610,19764,73191.4
160658,2019,University of Louisiana at Lafayette,LA,2536,2536,0,2414,92,30,2506,22948,47090.8
213358,2019,La Roche University,PA,205,205,0,141,34,30,175,43073,61014.96
110361,2019,California Baptist University,CA,1523,1523,0,1349,145,29,1494,48731,66849.57
170082,2019,Grand Valley State University,MI,4236,4235,1,3770,437,28,4207,24280,67198.25
171571,2019,Oakland University,MI,2667,2667,0,2582,57,28,2639,23778,78696.54
198969,2019,Methodist University,NC,378,377,1,232,117,28,349,55751,58239.21
134097,2019,Florida State University,FL,7106,7106,0,6313,766,27,7079,22278,60914.47
154527,2019,Wartburg College,IA,398,398,0,250,121,27,371,55508,58222.9
159647,2019,Louisiana Tech University,LA,2050,2050,0,1729,294,27,2023,21927,46738.12
110592,2019,California State University-Los Angeles,CA,3287,3287,0,3254,6,27,3260,15307,52850.08
110574,2019,California State University-East Bay,CA,1438,1438,0,1392,20,26,1412,23357,78750.43
217484,2019,University of Rhode Island,RI,3140,3139,1,1354,1759,26,3113,30339,72503.8
414823,2019,Johnson & Wales University-North Miami,FL,376,375,1,212,137,26,349,37686.031269160027,68856.12
142115,2019,Boise State University,ID,3027,3027,0,1604,1397,26,3001,21621,58298.66
204006,2019,Miami University-Hamilton,OH,563,562,1,521,15,26,536,16237,72182.76
181783,2019,Wayne State College,NE,730,730,0,587,118,25,705,19521,51810.1
106245,2019,University of Arkansas at Little Rock,AR,584,584,0,481,79,24,560,20416,51732.17
168740,2019,Andrews University,MI,283,281,2,81,177,23,258,40948,63096.48
102553,2019,University of Alaska Anchorage,AK,1356,1351,5,1269,59,23,1328,18946,72116.59
215655,2019,Robert Morris University,PA,732,723,9,590,110,23,700,47724,59274.33
142285,2019,University of Idaho,ID,1475,1453,22,1040,390,23,1430,21525,54125.14
218229,2019,Lander University,SC,943,943,0,843,77,23,920,24474,52256.85
173300,2019,Concordia College at Moorhead,MN,517,517,0,350,145,22,495,53819,60523.09
152600,2019,Valparaiso University,IN,647,647,0,314,311,22,625,53847,72576.06
130253,2019,Sacred Heart University,CT,1601,1601,0,396,1183,22,1579,61591,87263.76
234827,2019,Central Washington University,WA,2172,2170,2,2010,138,22,2148,24008,63170.67
199148,2019,University of North Carolina at Greensboro,NC,2746,2730,16,2604,105,21,2709,19179,60658.11
217819,2019,College of Charleston,SC,2051,2048,3,1009,1018,21,2027,29545,66962.7
217882,2019,Clemson University,SC,3932,3923,9,2271,1631,21,3902,32254,64586.36
112075,2019,Concordia University-Irvine,CA,342,342,0,231,90,21,321,53235,79890.85
151306,2019,University of Southern Indiana,IN,1585,1585,0,1382,183,20,1565,20146,57279.45
129941,2019,University of New Haven,CT,1285,1285,0,474,791,20,1265,58438,77310.15
139366,2019,Columbus State University,GA,1052,1052,0,944,88,20,1032,19807,55979.92
222831,2019,Angelo State University,TX,1436,1436,0,1394,22,20,1416,19810,49632.36
206437,2019,Walsh University,OH,394,394,0,348,27,19,375,42869,58552.19
110538,2019,California State University-Chico,CA,2561,2561,0,2527,15,19,2542,25073,61867.44
222178,2019,Abilene Christian University,TX,932,926,6,800,107,19,907,51577,67136.19
228149,2019,St. Mary's University,TX,545,545,0,501,25,19,526,42354,56236.53
218742,2019,University of South Carolina-Upstate,SC,881,876,5,804,53,19,857,23660,54689.19
181002,2019,Creighton University,NE,1076,1075,1,214,842,19,1056,56120,68443.5
219000,2019,Augustana University,SD,432,432,0,209,204,19,413,47710,60196.68
207324,2019,Oklahoma Christian University,OK,397,397,0,196,182,19,378,37015,63431.55
122506,2019,San Francisco Conservatory of Music,CA,57,57,0,15,23,19,38,69135,74879.37
159939,2019,University of New Orleans,LA,935,935,0,828,89,18,917,20864,51940.24
169248,2019,Central Michigan University,MI,2473,2473,0,2211,244,18,2455,25078,66048.2
227881,2019,Sam Houston State University,TX,2928,2927,1,2849,60,18,2909,22885,63900.24
197911,2019,Barton College,NC,319,319,0,241,60,18,301,46539,54814.93
215442,2019,Point Park University,PA,633,633,0,395,220,18,615,45350,54201.1
128498,2019,Albertus Magnus College,CT,246,246,0,192,37,17,229,49375,65065.75
239318,2019,Milwaukee School of Engineering,WI,582,582,0,360,205,17,565,53885,68757.09
150534,2019,University of Evansville,IN,445,444,1,268,159,17,427,50986,61532.75
217402,2019,Providence College,RI,1094,1090,4,100,973,17,1073,69407,83293.65
128744,2019,University of Bridgeport,CT,368,368,0,216,135,17,351,53853,63241.6
156620,2019,Eastern Kentucky University,KY,2349,2349,0,2018,314,17,2332,23384,47617.36
240417,2019,University of Wisconsin-Stout,WI,1491,1491,0,939,535,17,1474,19704,65020.23
213996,2019,Messiah University,PA,606,606,0,393,196,17,589,49864,71914.01
240277,2019,University of Wisconsin-Green Bay,WI,1346,1346,0,1236,93,17,1329,17509,63413.11
133650,2019,Florida Agricultural and Mechanical University,FL,1340,1339,1,988,335,16,1323,23312,52786.24
169442,2019,College for Creative Studies,MI,293,293,0,223,54,16,277,57085,74293.04
237330,2019,Concord University,WV,372,372,0,292,64,16,356,16824,41360.98
163976,2019,St. John's College,MD,127,127,0,17,94,16,111,50001,72041.37
219471,2019,University of South Dakota,SD,1308,1265,43,735,514,16,1249,23016,53799.09
110413,2019,California Lutheran University,CA,647,647,0,535,96,16,631,60668,81648.78
236595,2019,Seattle University,WA,930,924,6,350,559,15,909,63439,70785.55
229018,2019,The University of Texas of the Permian Basin,TX,402,402,0,362,25,15,387,17323,47475.29
240462,2019,University of Wisconsin-Platteville,WI,1494,1491,3,1153,323,15,1476,18670,61602.16
175856,2019,Jackson State University,MS,854,854,0,326,513,15,839,24570,43401.54
366711,2019,California State University-San Marcos,CA,2245,2245,0,2192,38,15,2230,22531,72827.06
182290,2019,University of Nevada-Reno,NV,3547,3546,1,2671,860,15,3531,23256,68050.29
123165,2019,Scripps College,CA,283,279,4,116,148,15,264,77588,79153.99
128771,2019,Central Connecticut State University,CT,1377,1377,0,1298,65,14,1363,22518,75579.11
169910,2019,Ferris State University,MI,1892,1891,1,1778,99,14,1877,23106,61040.62
138600,2019,Agnes Scott College,GA,299,299,0,166,119,14,285,55403,69580.95
138293,2019,Webber International University,FL,203,203,0,170,19,14,189,42702,55372.47
153269,2019,Drake University,IA,782,782,0,246,522,14,768,57643,70375.31
156213,2019,Asbury University,KY,292,292,0,164,114,14,278,42462,61842.48
181215,2019,University of Nebraska at Kearney,NE,863,863,0,783,66,14,849,23319,51335.53
482149,2019,Augusta University,GA,1119,1118,1,1035,69,14,1104,20115,64276.692131199976
207661,2019,Rogers State University,OK,601,601,0,573,15,13,588,20029,50487.79
199218,2019,University of North Carolina Wilmington,NC,2342,2332,10,2022,297,13,2319,24837,62176.12
168528,2019,Adrian College,MI,541,541,0,376,152,13,528,54621,66915.1
198950,2019,Meredith College,NC,376,371,5,321,37,13,358,50390,66301.42
212106,2019,Duquesne University,PA,1302,1299,3,918,368,13,1286,56199,61274.66
197869,2019,Appalachian State University,NC,3501,3495,6,3218,264,13,3482,19661,61267.04
152567,2019,Trine University,IN,618,617,1,371,233,13,604,47142,60275.33
110510,2019,California State University-San Bernardino,CA,2885,2885,0,2862,10,13,2872,19114,59070.9
198136,2019,Campbell University,NC,742,740,2,579,148,13,727,51131,56906.03
139311,2019,Clayton  State University,GA,597,596,1,569,14,13,583,18374,65444.71
174491,2019,University of Northwestern-St Paul,MN,408,408,0,306,89,13,395,43817,70065.41
213367,2019,La Salle University,PA,793,793,0,554,227,12,781,45298,67401.72
136330,2019,Palm Beach Atlantic University,FL,520,516,4,286,218,12,504,49839,64221.06
151342,2019,Indiana University-South Bend,IN,854,854,0,820,22,12,842,16667,59249.25
226383,2019,Lubbock Christian University,TX,282,282,0,242,28,12,270,37198,51468.15
217864,2019,Citadel Military College of South Carolina,SC,646,646,0,329,305,12,634,30022,66736.53
110486,2019,California State University-Bakersfield,CA,1561,1561,0,1529,20,12,1549,18661,53982.7
141334,2019,University of West Georgia,GA,1852,1802,50,1763,28,11,1791,23684,66454.08
202806,2019,Franklin University,OH,433,432,1,366,55,11,421,23956,59424.91
121309,2019,Point Loma Nazarene University,CA,612,612,0,438,163,11,601,53045,71269.62
206622,2019,Xavier University,OH,1210,1208,2,499,698,11,1197,58260,68472.8
240189,2019,University of Wisconsin-Whitewater,WI,2119,2119,0,1791,317,11,2108,18252,67955.05
123554,2019,Saint Mary's College of California,CA,517,517,0,447,59,11,506,69071,84232.87
181127,2019,Hastings College,NE,316,316,0,177,128,11,305,44893,58174.49
214175,2019,Muhlenberg College,PA,538,538,0,155,373,10,528,69413,89504.61
157809,2019,Thomas More University,KY,377,377,0,213,154,10,367,42003,64733.74
110404,2019,California Institute of Technology,CA,235,232,3,73,149,10,222,74763,81448.64
152530,2019,Taylor University,IN,490,489,1,227,252,10,479,48656,68822.46
160904,2019,Xavier University of Louisiana,LA,832,831,1,270,551,10,821,36391,55657.89
212160,2019,Edinboro University of Pennsylvania,PA,706,706,0,587,109,10,696,22036,52799.06
409698,2019,California State University-Monterey Bay,CA,1046,1046,0,1017,19,10,1036,23389,70802.17
229063,2019,Texas Southern University,TX,1475,1475,0,1263,203,9,1466,23173,53781.71
107512,2019,Ouachita Baptist University,AR,441,441,0,257,175,9,432,40200,61306.22
230807,2019,Westminster College,UT,283,283,0,138,136,9,274,49060,70649.66
225247,2019,Hardin-Simmons University,TX,479,478,1,454,15,9,469,42530,59593.97
228705,2019,Texas A & M University-Kingsville,TX,987,987,0,973,5,9,978,22645,45266.24
204617,2019,Ohio Dominican University,OH,287,287,0,267,11,9,278,42524,65362.52
216038,2019,Slippery Rock University of Pennsylvania,PA,1580,1580,0,1466,105,9,1571,24600,54113.09
225432,2019,University of Houston-Downtown,TX,1467,1467,0,1450,8,9,1458,20995,59551.33
213020,2019,Indiana University of Pennsylvania-Main Campus,PA,1921,1921,0,1823,89,9,1912,28442,54158.04
170967,2019,Rochester University,MI,142,142,0,126,8,8,134,33013,72043.03
141237,2019,Truett McConnell University,GA,215,215,0,184,23,8,207,33299,62186.38
199281,2019,University of North Carolina at Pembroke,NC,1131,1107,24,1033,66,8,1099,15952,49520.51
150163,2019,Butler University,IN,1116,1115,1,502,605,8,1107,61623,71968.39
217536,2019,Salve Regina University,RI,655,651,4,95,548,8,643,61072,81126.67
237899,2019,West Virginia State University,WV,273,273,0,200,65,8,265,19144,48790.55
181330,2019,Midland University,NE,317,317,0,163,146,8,309,45689,56723.06
218645,2019,University of South Carolina Aiken,SC,558,557,1,483,66,8,549,20735,53123.12
154235,2019,Saint Ambrose University,IA,477,477,0,109,360,8,469,46894,63314.56
218654,2019,University of South Carolina Beaufort,SC,449,445,4,368,69,8,437,24235,60345.78
212656,2019,Geneva College,PA,314,314,0,201,105,8,306,38941,55668.91
216010,2019,Shippensburg University of Pennsylvania,PA,1296,1296,0,1192,96,8,1288,29182,63560.54
180595,2019,Rocky Mountain College,MT,245,245,0,121,116,8,237,40804,51454.11
208822,2019,George Fox University,OR,603,603,0,309,286,8,595,51439,65616.22
139764,2019,Georgia Southwestern State University,GA,392,392,0,368,17,7,385,19125,49591.36
230834,2019,Castleton University,VT,397,397,0,231,159,7,390,24841,61392.97
203580,2019,Lake Erie College,OH,207,207,0,134,66,7,200,45740,63624.4
199102,2019,North Carolina A & T State University,NC,2289,2258,31,1695,556,7,2251,18348,56398.61
120184,2019,Notre Dame de Namur University,CA,120,120,0,100,13,7,113,37686.031269160027,89560.16
207458,2019,Oklahoma City University,OK,327,324,3,145,172,7,317,44942,59190.63
201548,2019,Capital University,OH,723,723,0,672,44,7,716,47719,64246.32
176053,2019,Mississippi College,MS,465,463,2,252,204,7,456,34918,52824.92
237118,2019,Alderson Broaddus University,WV,271,271,0,67,197,7,264,42676,44559.33
218070,2019,Furman University,SC,648,644,4,167,470,7,637,67299,71867.28
239716,2019,Saint Norbert College,WI,538,538,0,388,144,6,532,51383,71321.9
236577,2019,Seattle Pacific University,WA,638,621,17,391,224,6,615,60834,72206.46
173665,2019,Hamline University,MN,547,547,0,444,97,6,541,51984,70958.04
154712,2019,Benedictine College,KS,524,524,0,119,399,6,518,46309,64485.18
173045,2019,Augsburg University,MN,636,636,0,585,45,6,630,54069,72224.74
154013,2019,Mount Mercy University,IA,219,209,10,166,37,6,203,48189,61693.27
125763,2019,Whittier College,CA,493,485,8,355,124,6,479,61052,73825.46
221740,2019,The University of Tennessee-Chattanooga,TN,2310,2310,0,2178,126,6,2304,23436,55964.16
237792,2019,Shepherd University,WV,494,494,0,334,154,6,488,17759,62744.63
107071,2019,Henderson State University,AR,791,791,0,661,124,6,785,23005,45548.96
240374,2019,University of Wisconsin-Parkside,WI,657,657,0,573,78,6,651,16320,64274.59
214041,2019,Millersville University of Pennsylvania,PA,1334,1334,0,1208,120,6,1328,27526,65479.69
213598,2019,Lincoln University,PA,445,445,0,190,250,5,440,26008,51404.66
204194,2019,Mount Vernon Nazarene University,OH,324,324,0,274,45,5,319,43341,60597.42
155089,2019,Friends University,KS,177,177,0,112,60,5,172,39879,60343.56
155900,2019,Southwestern College,KS,160,160,0,58,97,5,155,46869,58156.66
213349,2019,Kutztown University of Pennsylvania,PA,1398,1398,0,1159,234,5,1393,28414,67783.54
160630,2019,Southern University at New Orleans,LA,221,221,0,203,13,5,216,16762,43920.92
155335,2019,Newman University,KS,184,184,0,146,33,5,179,41633,62008.99
217518,2019,Roger Williams University,RI,1113,1111,2,171,935,5,1106,54865,84094.11
227526,2019,Prairie View A & M University,TX,1727,1727,0,1495,227,5,1722,25164,57579.55
156286,2019,Bellarmine University,KY,617,615,2,428,182,5,610,56319,65601.28
180179,2019,Montana State University Billings,MT,611,611,0,556,50,5,606,16755,48720.57
226587,2019,McMurry University,TX,259,259,0,251,3,5,254,41764,52571.87
240471,2019,University of Wisconsin-River Falls,WI,1203,1203,0,570,628,5,1198,17971,69159.98
236328,2019,University of Puget Sound,WA,615,615,0,136,474,5,610,68072,72356.02
125897,2019,Woodbury University,CA,203,197,6,155,37,5,192,55032,60713.37
174127,2019,Minneapolis College of Art and Design,MN,178,177,1,98,74,5,172,53010,70094.27
140960,2019,Savannah State University,GA,812,811,1,655,151,5,806,16819,54220.88
216366,2019,Thomas Jefferson University,PA,632,629,3,388,236,5,624,60290,66565.04
131450,2019,Gallaudet University,DC,183,183,0,4,175,4,179,38892,65746.56
154688,2019,Baker University,KS,245,245,0,170,71,4,241,44473,67758.92
213613,2019,Lock Haven University,PA,598,598,0,557,37,4,594,25916,55815.84
221661,2019,Southern Adventist University,TN,512,493,19,121,368,4,489,35820,60144.84
199184,2019,University of North Carolina School of the Arts,NC,234,233,1,113,116,4,229,21755,68862.71
112084,2019,San Diego Christian College,CA,63,63,0,46,13,4,59,47755,66943.92
229179,2019,Texas Woman's University,TX,1301,1301,0,1275,22,4,1297,19418,69739.2
206349,2019,Ursuline College,OH,92,92,0,83,5,4,88,44600,60856.87
139861,2019,Georgia College & State University,GA,1481,1481,0,1468,9,4,1477,28707,68382.02
203368,2019,John Carroll University,OH,725,725,0,474,248,3,722,57651,68368.11
150604,2019,Franklin College,IN,270,270,0,250,17,3,267,46533,61682.88
210429,2019,Western Oregon University,OR,789,788,1,596,189,3,785,22810,59410.15
240480,2019,University of Wisconsin-Stevens Point,WI,1529,1529,0,1359,167,3,1526,18217,62211.59
122454,2019,San Francisco Art Institute,CA,32,26,6,13,10,3,23,70023,72969.6
128780,2019,Charter Oak State College,CT,47,47,0,27,17,3,44,16369,63157.4
218733,2019,South Carolina State University,SC,371,371,0,318,50,3,368,30015,48129.81
207847,2019,Southeastern Oklahoma State University,OK,518,517,1,362,152,3,514,16367,41386.98
151379,2019,Indiana University-Southeast,IN,948,946,2,702,241,3,943,17421,57669.69
181446,2019,Nebraska Wesleyan University,NE,487,487,0,368,116,3,484,48718,59199.51
445708,2019,Johnson & Wales University-Charlotte,NC,428,428,0,142,283,3,425,50200,68856.12
212197,2019,Elizabethtown College,PA,377,377,0,271,103,3,374,44978,70213.56
217925,2019,Columbia International University,SC,132,132,0,67,62,3,129,36979,64434.93
152336,2019,University of Saint Francis-Fort Wayne,IN,394,394,0,342,49,3,391,40759,63802.5
203517,2019,Kent State University at Kent,OH,4307,4232,75,3442,787,3,4229,25836,59479.84
204264,2019,Muskingum University,OH,388,387,1,337,47,3,384,41716,57566.05
211088,2019,Arcadia University,PA,530,529,1,320,206,3,526,59684,72830.78
211468,2019,Cedar Crest College,PA,205,205,0,143,59,3,202,52279,66384.94
203085,2019,Heidelberg University,OH,332,332,0,272,57,3,329,44381,61648.4
212133,2019,Eastern University,PA,357,356,1,237,116,3,353,48828,68457.57
224527,2019,East Texas Baptist University,TX,350,350,0,302,46,2,348,38749,56363.11
200800,2019,University of Akron Main Campus,OH,2739,2739,0,2505,232,2,2737,24604,58778.75
163578,2019,Notre Dame of Maryland University,MD,87,87,0,72,13,2,85,52667,70799.46
203845,2019,Marietta College,OH,348,348,0,244,102,2,346,49601,58715.65
198756,2019,Johnson C Smith University,NC,328,327,1,165,160,2,325,33444,57295.75
217420,2019,Rhode Island College,RI,953,953,0,770,181,2,951,17761,61569.63
152390,2019,Saint Mary's College,IN,381,377,4,122,253,2,375,58956,72879.94
218539,2019,Presbyterian College,SC,342,342,0,227,113,2,340,53720,62666.83
118888,2019,Mills College,CA,134,134,0,94,38,2,132,48360,71756.45
129215,2019,Eastern Connecticut State University,CT,874,871,3,773,96,2,869,27425,76020.15
173452,2019,Martin Luther College,MN,168,168,0,17,149,2,166,27230,64939.16
130493,2019,Southern Connecticut State University,CT,1523,1520,3,1460,58,2,1518,25413,74581.97
199157,2019,North Carolina Central University,NC,1027,1011,16,806,203,2,1009,24075,57501.19
224323,2019,University of Dallas,TX,382,375,7,199,175,1,374,58050,75912.69
213783,2019,Mansfield University of Pennsylvania,PA,450,450,0,371,78,1,449,24278,51271.33
214272,2019,Neumann University,PA,418,418,0,269,148,1,417,50640,69149.16
157058,2019,Kentucky State University,KY,525,524,1,193,330,1,523,16885,51636.62
203128,2019,Hiram College,OH,228,228,0,167,60,1,227,50555,63946.73
209612,2019,Pacific University,OR,416,416,0,169,246,1,415,62157,64591.02
130314,2019,University of Saint Joseph,CT,204,203,1,181,21,1,202,50959,74607
216542,2019,University of Valley Forge,PA,110,110,0,41,68,1,109,36036,63922.06
235167,2019,The Evergreen State College,WA,260,260,0,184,75,1,259,24371,63843.36
216764,2019,West Chester University of Pennsylvania,PA,2871,2870,1,2544,325,1,2869,26114,74655.83
133872,2019,AdventHealth University,FL,64,64,0,55,8,1,63,33648,60028.37
129534,2019,Holy Apostles College and Seminary,CT,15,15,0,1,13,1,14,37686.031269160027,64276.692131199976
154350,2019,Simpson College,IA,294,294,0,231,62,1,293,53845,60274.33
123572,2019,Sonoma State University,CA,1551,1551,0,1533,17,1,1550,26537,75511.05
132879,2019,Johnson University Florida,FL,56,56,0,52,3,1,55,27611,59004.31
215798,2019,Saint Vincent College,PA,359,359,0,286,72,1,358,50140,54143.22
225399,2019,Houston Baptist University,TX,727,717,10,698,18,1,716,43638,72476.33
441937,2019,California State University-Channel Islands,CA,887,887,0,882,4,1,886,25150,78662.36
440828,2019,Oregon State University-Cascades Campus,OR,135,135,0,110,24,1,134,25945,60312.67
214148,2019,Moore College of Art and Design,PA,103,103,0,47,55,1,102,60910,70661.87
155812,2019,University of Saint Mary,KS,149,149,0,78,70,1,148,42175,62613.14
489779,2019,Purdue University Global,IN,866,863,3,80,782,1,862,37686.031269160027,64276.692131199976
209807,2019,Portland State University,OR,1674,1653,21,1298,354,1,1652,20571,62889.32
217934,2019,Columbia College,SC,176,176,0,149,26,1,175,33178,56463.66
173160,2019,Bethel University,MN,586,586,0,472,113,1,585,52723,77038.37
203465,2019,Kent State University at Stark,OH,539,538,1,537,0,1,537,12914,59479.84
225575,2019,Huston-Tillotson University,TX,204,204,0,192,11,1,203,24148,57117.25
113582,2019,Design Institute of San Diego,CA,8,8,0,5,2,1,7,42928,71383.01
201195,2019,Baldwin Wallace University,OH,665,665,0,479,185,1,664,48655,66257.54
161217,2019,University of Maine at Augusta,ME,345,344,1,330,13,1,343,16948,48750.5
490805,2019,Purdue University Northwest,IN,1235,1235,0,1116,119,0,1235,17408,64276.692131199976
139719,2019,Fort Valley State University,GA,388,388,0,351,37,0,388,20264,53364.82
180878,2019,Bryan College of Health Sciences,NE,72,72,0,70,2,0,72,30615,58151.07
120838,2019,Pacific States University,CA,1,1,0,1,0,0,1,37686.031269160027,64276.692131199976
438586,2019,American InterContinental University-Atlanta,GA,98,98,0,98,0,0,98,21048,58772.86
216852,2019,Widener University,PA,762,758,4,473,285,0,758,62831,69397.52
151786,2019,Marian University,IN,385,379,6,312,67,0,379,49112,65206.92
211477,2019,Central Penn College,PA,105,105,0,96,9,0,105,27042,56698.35
198516,2019,Elon University,NC,1659,1621,38,279,1342,0,1621,52587,81102.4
111188,2019,California State University Maritime Academy,CA,190,190,0,158,32,0,190,28149,78248.99
490230,2019,Reformed University,GA,35,31,4,31,0,0,31,21060,64276.692131199976
162210,2019,Washington Adventist University,MD,128,123,5,75,48,0,123,33721,69837.96
482635,2019,DeVry University-Texas,TX,10,10,0,10,0,0,10,33151,64276.692131199976
132471,2019,Barry University,FL,717,690,27,397,293,0,690,47118,58621.88
198598,2019,Greensboro College,NC,181,181,0,140,41,0,181,30302,63893.94
156125,2019,Wichita State University,KS,1689,1610,79,1264,346,0,1610,20418,60078.99
137564,2019,Southeastern University,FL,1389,1364,25,659,705,0,1364,39276,60101.07
168786,2019,Aquinas College,MI,262,251,11,228,23,0,251,43921,64829.33
199999,2019,Winston-Salem State University,NC,967,961,6,837,124,0,961,20382,54716.68
157289,2019,University of Louisville,KY,2803,2783,20,2197,586,0,2783,28247,59042.66
213774,2019,Manor College,PA,174,174,0,170,4,0,174,25964,60787.72
168847,2019,Baker College,MI,690,689,1,663,26,0,689,19593,59405.88
433420,2019,California Aeronautical University,CA,49,49,0,44,5,0,49,42622,65732.08
198507,2019,Elizabeth City State University,NC,385,377,8,307,70,0,377,12754,47337.89
485546,2019,California Intercontinental University,CA,17,15,2,5,10,0,15,37686.031269160027,64276.692131199976
482608,2019,DeVry University-Pennsylvania,PA,6,6,0,6,0,0,6,34602,64276.692131199976
204200,2019,Mount Saint Joseph University,OH,290,290,0,209,81,0,290,39248,64120.45
181020,2019,Doane University,NE,319,314,5,221,93,0,314,50470,57123.16
227863,2019,University of St Thomas,TX,343,342,1,332,10,0,342,42652,71790.89
482459,2019,DeVry University-Florida,FL,28,28,0,25,3,0,28,37295,64276.692131199976
203960,2019,Mercy College of Ohio,OH,44,44,0,36,8,0,44,22784,58075.98
445133,2019,American InterContinental University-Houston,TX,23,23,0,23,0,0,23,21745,58772.86
111966,2019,Charles R Drew University of Medicine and Science,CA,13,11,2,11,0,0,11,33171,55906.67
159009,2019,Grambling State University,LA,874,870,4,473,397,0,870,24332,44602.47
216357,2019,Thiel College,PA,248,247,1,153,94,0,247,48566,54604.75
238193,2019,Alverno College,WI,171,170,1,149,21,0,170,40724,58784.16
212984,2019,Holy Family University,PA,344,343,1,295,48,0,343,37020,61868.46
224554,2019,Texas A & M University-Commerce,TX,971,967,4,938,29,0,967,22575,57562.14
204936,2019,Otterbein University,OH,623,623,0,558,65,0,623,45773,67882
414878,2019,Trine University-Regional/Non-Traditional Campuses,IN,1,1,0,0,1,0,1,37686.031269160027,60275.33
482547,2019,DeVry University-Nevada,NV,3,3,0,3,0,0,3,34274,64276.692131199976
477039,2019,West Coast University-Dallas,TX,3,3,0,3,0,0,3,27991,64276.692131199976
420042,2019,University of Phoenix-Hawaii,HI,2,2,0,2,0,0,2,18992,62086.89
199607,2019,Salem College,NC,109,106,3,98,8,0,106,44461,59058
458210,2019,West Coast University-Orange County,CA,14,12,2,12,0,0,12,41865,64276.692131199976
181604,2019,College of Saint Mary,NE,105,105,0,81,24,0,105,31250,62625.82
160074,2019,Franciscan Missionaries of Our Lady University,LA,78,71,7,71,0,0,71,26751,54007.12
408844,2019,Florida National University-Main Campus,FL,468,462,6,458,4,0,462,28378,51661.46
161457,2019,University of New England,ME,712,712,0,163,549,0,712,56844,64934.4
136172,2019,University of North Florida,FL,2641,2606,35,2512,94,0,2606,19469,62628.24
198303,2019,Chowan University,NC,400,400,0,225,175,0,400,37161,53634.23
484756,2019,University of Phoenix-Texas,TX,2,2,0,2,0,0,2,16367,64276.692131199976
217305,2019,New England Institute of Technology,RI,481,473,8,184,289,0,473,45601,64106.73
206279,2019,Union Institute & University,OH,5,5,0,2,3,0,5,31656,59714.64
202763,2019,The University of Findlay,OH,520,518,2,405,113,0,518,47032,61890.4
155681,2019,Pittsburg State University,KS,880,878,2,542,336,0,878,18657,50242.27
200013,2019,Rasmussen College-North Dakota,ND,29,29,0,25,4,0,29,23022,52350.64
240338,2019,Wisconsin Lutheran College,WI,214,214,0,176,38,0,214,43118,69126.34
140234,2019,LaGrange College,GA,250,250,0,203,47,0,250,46034,61341.56
125231,2019,Walden University,MN,148,148,0,3,145,0,148,37686.031269160027,62475.08
198543,2019,Fayetteville State University,NC,678,644,34,602,42,0,644,16623,49808.38
482565,2019,DeVry University-North Carolina,NC,1,1,0,0,1,0,1,37686.031269160027,64276.692131199976
482574,2019,DeVry University-Ohio,OH,21,21,0,21,0,0,21,34949,64276.692131199976
239390,2019,Mount Mary University,WI,126,126,0,113,13,0,126,44284,62361.14
474863,2019,Los Angeles Pacific University,CA,34,34,0,26,8,0,34,26995,64276.692131199976
482617,2019,DeVry University-Tennessee,TN,4,4,0,3,1,0,4,37460,64276.692131199976
227331,2019,Our Lady of the Lake University,TX,330,324,6,321,3,0,324,40753,52505.04
433387,2019,Western Governors University,UT,28,28,0,2,26,0,28,13790,62039.21
238263,2019,Madison Area Technical College,WI,1760,1727,33,1699,28,0,1727,14210,64533.76
230056,2019,Broadview University-West Jordan,UT,37,37,0,33,4,0,37,27859,70004.7
213011,2019,Immaculata University,PA,259,259,0,175,84,0,259,44036,74355.43
180814,2019,Bellevue University,NE,124,124,0,31,93,0,124,22961,63424.91
482431,2019,DeVry University-California,CA,88,88,0,86,2,0,88,35697,64276.692131199976
209241,2019,Mount Angel Seminary,OR,6,6,0,1,5,0,6,39700,59323.69
114123,2019,Empire College,CA,139,139,0,139,0,0,139,37686.031269160027,70826.06
156471,2019,Galen College of Nursing-Louisville,KY,48,48,0,34,14,0,48,37686.031269160027,54499.36
206862,2019,Southern Nazarene University,OK,283,280,3,177,103,0,280,38327,57571.98
450571,2019,Rasmussen College-Wisconsin,WI,27,27,0,27,0,0,27,23497,64276.692131199976
214883,2019,Peirce College,PA,50,50,0,48,2,0,50,18260,49493.53
176406,2019,Tougaloo College,MS,125,125,0,74,51,0,125,22784,44758.77
484631,2019,University of Phoenix-California,CA,18,18,0,18,0,0,18,18184,64276.692131199976
211981,2019,Delaware Valley University,PA,377,377,0,213,164,0,377,56828,74767.83
482468,2019,DeVry University-Georgia,GA,64,64,0,63,1,0,64,34215,64276.692131199976
460349,2019,Johnson & Wales University-Online,RI,19,19,0,0,19,0,19,25224,64276.692131199976
183257,2019,Granite State College,NH,79,79,0,55,24,0,79,18834,59743.94
203474,2019,Kent State University at Trumbull,OH,215,215,0,215,0,0,215,13328,59479.84
482486,2019,DeVry University-Indiana,IN,1,1,0,1,0,0,1,24764,64276.692131199976
214069,2019,Misericordia University,PA,414,414,0,271,143,0,414,48844,56588.57
219709,2019,Belmont University,TN,1684,1674,10,429,1245,0,1674,54595,70368.62
219602,2019,Austin Peay State University,TN,1716,1647,69,1501,146,0,1647,23931,52472.51
461528,2019,Grace College of Divinity,NC,16,14,2,9,5,0,14,14977,64276.692131199976
228981,2019,Texas Lutheran University,TX,419,419,0,414,5,0,419,42208,65468.32
181297,2019,Nebraska Methodist College of Nursing & Allied Health,NE,48,48,0,36,12,0,48,31690,66507.51
110680,2020,University of California-San Diego,CA,6447,6441,6,4808,508,1125,5316,33240,76397.62
236948,2020,University of Washington-Seattle Campus,WA,7027,7027,0,4464,1486,1077,5950,26825,69752.4
110653,2020,University of California-Irvine,CA,5765,5762,3,4490,202,1070,4692,34355,78085.65
110635,2020,University of California-Berkeley,CA,6117,6117,0,4542,796,779,5338,39016,77601.85
110662,2020,University of California-Los Angeles,CA,6386,6385,1,4779,1007,599,5786,35497,72896.84
240444,2020,University of Wisconsin-Madison,WI,7306,7305,1,3778,2966,561,6744,26393,71185.17
123961,2020,University of Southern California,CA,3459,3372,87,1459,1483,430,2942,77362,76787.41
110705,2020,University of California-Santa Barbara,CA,4847,4845,2,4016,405,424,4421,36492,73046.19
204796,2020,Ohio State University-Main Campus,OH,8679,8675,4,6140,2195,340,8335,27202,65208.79
129020,2020,University of Connecticut,CT,3825,3809,16,2361,1115,333,3476,33896,80999.86
139755,2020,Georgia Institute of Technology-Main Campus,GA,3260,3212,48,1744,1157,311,2901,29291,77933.64
228778,2020,The University of Texas at Austin,TX,8459,8419,40,7609,505,305,8114,27397,72284.1
211440,2020,Carnegie Mellon University,PA,1637,1637,0,140,1193,304,1333,74489,81652.61
140951,2020,Savannah College of Art and Design,GA,2128,2124,4,322,1510,292,1832,58367,71588.69
174066,2020,University of Minnesota-Twin Cities,MN,5966,5942,24,4179,1472,291,5651,27654,70741.62
134130,2020,University of Florida,FL,6333,6228,105,5143,806,279,5949,21151,60120.16
137351,2020,University of South Florida,FL,5734,5683,51,4869,539,275,5408,21134,58397.57
215062,2020,University of Pennsylvania,PA,2316,2247,69,380,1606,261,1986,78186,78252
139658,2020,Emory University,GA,1344,1344,0,155,933,256,1088,72604,80509.92
170976,2020,University of Michigan-Ann Arbor,MI,6879,6876,3,3519,3117,240,6636,30926,77145.9
217156,2020,Brown University,RI,1751,1745,6,58,1449,238,1507,77490,79027.35
201645,2020,Case Western Reserve University,OH,1305,1305,0,245,823,237,1068,69526,69873.4
139940,2020,Georgia State University,GA,5518,5417,101,4430,750,237,5180,27206,72190.32
227216,2020,University of North Texas,TX,5304,5293,11,4870,217,206,5087,23770,72891.36
243744,2020,Stanford University,CA,1606,1606,0,528,876,202,1404,74570,80275.59
162928,2020,Johns Hopkins University,MD,1405,1367,38,135,1040,192,1175,74001,81539.46
230764,2020,University of Utah,UT,4483,4434,49,2826,1421,187,4247,20303,69474.52
201885,2020,University of Cincinnati-Main Campus,OH,5242,5229,13,4119,932,178,5051,26892,64722.83
131469,2020,George Washington University,DC,1978,1927,51,33,1732,162,1765,74023,85677.46
228796,2020,The University of Texas at El Paso,TX,3344,3344,0,3122,61,161,3183,18291,46777.52
221999,2020,Vanderbilt University,TN,1698,1690,8,152,1380,158,1532,73148,76279.78
152080,2020,University of Notre Dame,IN,2193,2193,0,152,1896,145,2048,74172,76710.92
130794,2020,Yale University,CT,1264,1264,0,87,1036,141,1123,76645,75345.96
122612,2020,University of San Francisco,CA,1142,1142,0,664,338,140,1002,69987,82472.56
131496,2020,Georgetown University,DC,1584,1584,0,21,1425,138,1446,76280,82187.36
199847,2020,Wake Forest University,NC,1452,1452,0,240,1078,134,1318,74135,80539.14
212054,2020,Drexel University,PA,2339,2321,18,1041,1150,130,2191,69397,74533.27
160755,2020,Tulane University of Louisiana,LA,1801,1787,14,181,1477,129,1658,75628,69803.28
204024,2020,Miami University-Oxford,OH,3824,3821,3,2308,1384,129,3692,33805,72182.76
122409,2020,San Diego State University,CA,4852,4852,0,4014,711,127,4725,23367,68953.33
486840,2020,Kennesaw State University,GA,8018,7905,113,7629,160,116,7789,25059,64276.692131199976
223232,2020,Baylor University,TX,3731,3722,9,2260,1348,114,3608,65222,73627.32
207500,2020,University of Oklahoma-Norman Campus,OK,4422,4419,3,2390,1916,113,4306,29577,59522.71
117946,2020,Loyola Marymount University,CA,1468,1461,7,815,534,112,1349,70235,78631.93
225511,2020,University of Houston,TX,5225,5219,6,5004,105,110,5109,23361,68874.27
109651,2020,Art Center College of Design,CA,233,233,0,104,25,104,129,66046,74131.88
228769,2020,The University of Texas at Arlington,TX,3900,3900,0,3721,77,102,3798,23902,66876.51
227757,2020,Rice University,TX,993,966,27,399,465,102,864,67102,77707.58
131520,2020,Howard University,DC,2360,2355,5,10,2244,101,2254,45971,66680.2
198419,2020,Duke University,NC,1580,1556,24,213,1247,96,1460,77846,78468.48
217493,2020,Rhode Island School of Design,RI,414,381,33,6,281,94,287,72571,80568.35
181464,2020,University of Nebraska-Lincoln,NE,4771,4765,6,3480,1191,94,4671,24400,60976.73
216339,2020,Temple University,PA,4856,4855,1,3433,1328,94,4761,33226,66650.68
215293,2020,University of Pittsburgh-Pittsburgh Campus,PA,4230,4206,24,2485,1628,93,4113,33964,58452.18
110671,2020,University of California-Riverside,CA,4852,4851,1,4730,32,89,4762,30561,68292.12
122931,2020,Santa Clara University,CA,1259,1217,42,676,457,84,1133,74297,93581.09
163268,2020,University of Maryland-Baltimore County,MD,1675,1664,11,1493,91,80,1584,25997,83010.29
169080,2020,Calvin University,MI,660,660,0,364,219,77,583,50191,70660.49
131159,2020,American University,DC,1607,1606,1,31,1501,74,1532,66416,81657.17
199193,2020,North Carolina State University at Raleigh,NC,4747,4728,19,4135,519,74,4654,24202,64180.75
130590,2020,Trinity College,CT,572,565,7,85,407,73,492,76850,81265.21
229115,2020,Texas Tech University,TX,6522,6518,4,6014,431,73,6445,23191,65284.89
228723,2020,Texas A & M University-College Station,TX,11110,11108,2,10530,506,72,11036,29920,67194.13
136215,2020,Nova Southeastern University,FL,1689,1573,116,985,519,69,1504,50429,62876.89
110370,2020,California College of the Arts,CA,191,189,2,76,45,68,121,68956,73343.27
204501,2020,Oberlin College,OH,679,661,18,37,556,68,593,77124,76190.1
130943,2020,University of Delaware,DE,4175,4175,0,1722,2386,67,4108,28708,84189.75
108232,2020,Academy of Art University,CA,794,784,10,229,490,65,719,43976,74015.06
163286,2020,University of Maryland-College Park,MD,5369,5356,13,3977,1316,63,5293,27343,90010.73
110583,2020,California State University-Long Beach,CA,4908,4908,0,4787,58,63,4845,19846,66954.9
111948,2020,Chapman University,CA,1586,1586,0,998,526,62,1524,74336,73437.32
209551,2020,University of Oregon,OR,3920,3911,9,1902,1949,60,3851,27717,62294.9
207388,2020,Oklahoma State University-Main Campus,OK,4154,4149,5,2643,1446,60,4089,23906,55237.91
220978,2020,Middle Tennessee State University,TN,3093,3092,1,2693,340,59,3033,21241,60340.43
228875,2020,Texas Christian University,TX,2287,2280,7,1020,1202,58,2222,68072,76266.48
122755,2020,San Jose State University,CA,3328,3328,0,3220,50,58,3270,25747,88589.14
137847,2020,The University of Tampa,FL,2069,2061,8,398,1606,57,2004,46341,71934.52
206084,2020,University of Toledo,OH,2363,2352,11,1862,434,56,2296,25118,60626.38
151111,2020,Indiana University-Purdue University-Indianapolis,IN,3811,3810,1,3551,204,55,3755,21127,64749.24
183026,2020,Southern New Hampshire University,NH,15720,15352,368,1243,14055,54,15298,50505,71986.54
230959,2020,Middlebury College,VT,602,555,47,17,484,54,501,74248,77169.17
399911,2020,Soka University of America,CA,102,102,0,28,20,54,48,50968,79623.38
461148,2020,New York Film Academy,CA,190,188,2,46,88,54,134,54738,64276.692131199976
163295,2020,Maryland Institute College of Art,MD,289,289,0,84,152,53,236,66413,80395.11
211291,2020,Bucknell University,PA,986,986,0,223,711,52,934,75400,84046.3
218663,2020,University of South Carolina-Columbia,SC,5742,5711,31,3366,2293,52,5659,28602,62188.24
490133,2020,Westcliff University,CA,131,131,0,63,17,51,80,22466,64276.692131199976
207582,2020,Oral Roberts University,OK,643,643,0,242,350,51,592,44006,63453.08
134097,2020,Florida State University,FL,6006,6004,2,5222,731,51,5953,22278,60914.47
157085,2020,University of Kentucky,KY,4891,4882,9,3034,1798,50,4832,30178,59287.73
156365,2020,Campbellsville University,KY,689,689,0,543,96,50,639,38502,47586.61
121150,2020,Pepperdine University,CA,733,723,10,336,337,50,673,75312,79068.51
117751,2020,The Master's University and Seminary,CA,681,681,0,359,273,49,632,40783,71662.94
122597,2020,San Francisco State University,CA,2779,2777,2,2702,27,48,2729,24513,77495.51
112260,2020,Claremont McKenna College,CA,315,315,0,135,133,47,268,76475,82855.72
240453,2020,University of Wisconsin-Milwaukee,WI,3249,3248,1,2846,355,47,3201,21984,65921.14
228787,2020,The University of Texas at Dallas,TX,3476,3476,0,3246,185,45,3431,27120,79361.13
159391,2020,Louisiana State University and Agricultural & Mechanical College,LA,6701,6692,9,4795,1852,45,6647,32724,57504.74
236939,2020,Washington State University,WA,4191,4172,19,3406,721,45,4127,26068,63710
181394,2020,University of Nebraska at Omaha,NE,2223,2221,2,2015,161,45,2176,19797,66043.01
211273,2020,Bryn Mawr College,PA,359,359,0,40,275,44,315,73540,78969.24
228246,2020,Southern Methodist University,TX,1531,1510,21,606,860,44,1466,76346,82038.46
157447,2020,Northern Kentucky University,KY,1836,1836,0,1207,586,43,1793,17869,63568.77
120403,2020,Otis College of Art and Design,CA,225,225,0,133,49,43,182,66695,73811.67
174914,2020,University of St Thomas,MN,1487,1485,2,1153,291,41,1444,57785,76939.14
110608,2020,California State University-Northridge,CA,4016,4016,0,3929,46,41,3975,19794,64055.44
199139,2020,University of North Carolina at Charlotte,NC,3999,3960,39,3658,261,41,3919,23478,65762.02
188030,2020,New Mexico State University-Main Campus,NM,2169,2153,16,1541,571,41,2112,19760,43867.23
129525,2020,University of Hartford,CT,1141,1137,4,470,627,40,1097,57475,82221.8
111081,2020,California Institute of the Arts,CA,151,151,0,52,60,39,112,74111,74875.2
229027,2020,The University of Texas at San Antonio,TX,5333,5333,0,5210,85,38,5295,18923,63798.29
216597,2020,Villanova University,PA,1700,1685,15,284,1363,38,1647,73042,90091.77
182281,2020,University of Nevada-Las Vegas,NV,4475,4461,14,3752,671,38,4423,18756,70070.97
130226,2020,Quinnipiac University,CT,1757,1757,0,470,1249,38,1719,66237,87986.1
110529,2020,California State Polytechnic University-Pomona,CA,4323,4323,0,4246,39,38,4285,22365,68064.96
202480,2020,University of Dayton,OH,2134,2134,0,1099,997,38,2096,60900,75690.27
110556,2020,California State University-Fresno,CA,3693,3693,0,3625,31,37,3656,17683,53295.09
169716,2020,University of Detroit Mercy,MI,419,416,3,354,25,37,379,38440,64142.33
202134,2020,Cleveland State University,OH,1799,1799,0,1664,98,37,1762,24010,57782.89
141574,2020,University of Hawaii at Manoa,HI,2184,2160,24,1347,776,37,2123,23405,71646.27
134945,2020,Jacksonville University,FL,686,686,0,366,284,36,650,54991,63671.93
227368,2020,The University of Texas Rio Grande Valley,TX,5338,5338,0,5287,16,35,5303,14250,35906.7
209922,2020,Reed College,OR,364,364,0,33,296,35,329,75586,71777.6
234915,2020,City University of Seattle,WA,72,68,4,24,9,35,33,37686.031269160027,67486.66
172644,2020,Wayne State University,MI,3120,3120,0,3024,62,34,3086,24541,61912.62
139931,2020,Georgia Southern University,GA,5341,5338,3,5046,258,34,5304,22608,62772.56
217484,2020,University of Rhode Island,RI,3302,3295,7,1329,1933,33,3262,30339,72503.8
131283,2020,The Catholic University of America,DC,630,629,1,18,578,33,596,65857,85196.61
220862,2020,University of Memphis,TN,2540,2540,0,2098,409,33,2507,24139,58823.6
206437,2020,Walsh University,OH,390,390,0,328,29,33,357,42869,58552.19
217165,2020,Bryant University,RI,806,806,0,64,710,32,774,62855,80219.8
136950,2020,Rollins College,FL,504,504,0,265,207,32,472,66805,69363.5
239105,2020,Marquette University,WI,1651,1651,0,566,1053,32,1619,59725,75591.25
107044,2020,Harding University,AR,747,747,0,204,511,32,715,31647,61757.88
141644,2020,Hawaii Pacific University,HI,522,519,3,145,343,31,488,47698,72804.49
199962,2020,Wingate University,NC,825,825,0,486,308,31,794,49769,65044.99
132903,2020,University of Central Florida,FL,8037,8026,11,7395,600,31,7995,21309,62518.63
221759,2020,The University of Tennessee-Knoxville,TN,5512,5512,0,3828,1653,31,5481,32010,60752.93
201654,2020,Cedarville University,OH,918,918,0,362,526,30,888,42318,67472.37
114354,2020,FIDM-Fashion Institute of Design & Merchandising-Los Angeles,CA,341,341,0,167,144,30,311,51281,73476
142294,2020,The College of Idaho,ID,267,267,0,171,67,29,238,45607,57741.96
230807,2020,Westminster College,UT,180,180,0,78,74,28,152,49060,70649.66
209056,2020,Lewis & Clark College,OR,512,507,5,60,419,28,479,68735,69786.29
122436,2020,University of San Diego,CA,997,985,12,579,379,27,958,70440,79883.39
110565,2020,California State University-Fullerton,CA,5425,5425,0,5369,29,27,5398,17791,73036.4
482158,2020,Middle Georgia State University,GA,1448,1445,3,1239,180,26,1419,15822,64276.692131199976
139959,2020,University of Georgia,GA,5646,5642,4,4843,773,26,5616,27329,71225.06
110617,2020,California State University-Sacramento,CA,3761,3761,0,3686,49,26,3735,21576,65686.13
228149,2020,St. Mary's University,TX,514,513,1,473,14,26,487,42354,56236.53
110361,2020,California Baptist University,CA,1360,1360,0,1211,123,26,1334,48731,66849.57
225627,2020,University of the Incarnate Word,TX,922,922,0,869,28,25,897,45532,59715.43
107141,2020,John Brown University,AR,315,315,0,117,173,25,290,40774,56884.69
163204,2020,University of Maryland Global Campus,MD,664,661,3,253,383,25,636,19764,73191.4
227845,2020,Saint Edward's University,TX,595,586,9,490,71,25,561,61707,71197.81
168740,2020,Andrews University,MI,257,257,0,56,177,24,233,40948,63096.48
120254,2020,Occidental College,CA,402,400,2,175,201,24,376,76600,75275.66
110592,2020,California State University-Los Angeles,CA,4000,4000,0,3961,15,24,3976,15307,52850.08
171571,2020,Oakland University,MI,2258,2257,1,2181,53,23,2234,23778,78696.54
222178,2020,Abilene Christian University,TX,859,859,0,746,90,23,836,51577,67136.19
229267,2020,Trinity University,TX,634,634,0,505,106,23,611,60664,78650.29
201441,2020,Bowling Green State University-Main Campus,OH,3081,3078,3,2723,332,23,3055,24529,63749.73
130253,2020,Sacred Heart University,CT,1650,1647,3,362,1262,23,1624,61591,87263.76
154527,2020,Wartburg College,IA,468,468,0,310,135,23,445,55508,58222.9
187985,2020,University of New Mexico-Main Campus,NM,2790,2777,13,2227,527,23,2754,19351,49538.77
204857,2020,Ohio University-Main Campus,OH,3132,3132,0,2687,422,23,3109,29534,59563.35
198516,2020,Elon University,NC,1587,1571,16,294,1255,22,1549,52587,81102.4
230816,2020,Bennington College,VT,141,141,0,3,116,22,119,75972,77879.63
199759,2020,Southeastern Baptist Theological Seminary,NC,156,149,7,92,35,22,127,18955,64276.692131199976
198969,2020,Methodist University,NC,352,352,0,220,111,21,331,55751,58239.21
212106,2020,Duquesne University,PA,1195,1190,5,816,353,21,1169,56199,61274.66
213358,2020,La Roche University,PA,196,196,0,149,27,20,176,43073,61014.96
110404,2020,California Institute of Technology,CA,225,220,5,93,107,20,200,74763,81448.64
482680,2020,University of North Georgia,GA,4320,4315,5,4213,82,20,4295,16816,64276.692131199976
168528,2020,Adrian College,MI,535,531,4,373,138,20,511,54621,66915.1
170082,2020,Grand Valley State University,MI,3786,3786,0,3391,376,19,3767,24280,67198.25
230038,2020,Brigham Young University,UT,6310,5750,560,2020,3711,19,5731,18936,64914.81
209825,2020,University of Portland,OR,809,807,2,236,552,19,788,64049,67900.72
213598,2020,Lincoln University,PA,447,447,0,184,245,18,429,26008,51404.66
215770,2020,Saint Joseph's University,PA,847,840,7,357,465,18,822,63223,79940.44
206941,2020,University of Central Oklahoma,OK,1940,1938,2,1838,82,18,1920,24185,54764.86
120883,2020,University of the Pacific,CA,718,715,3,639,58,18,697,64784,72621.06
123952,2020,Southern California Institute of Architecture,CA,27,27,0,0,9,18,9,70734,66525.34
151263,2020,University of Indianapolis,IN,945,944,1,799,127,18,926,44681,63891.1
198695,2020,High Point University,NC,1387,1386,1,382,987,17,1369,54296,63207.13
199412,2020,Queens University of Charlotte,NC,335,335,0,172,146,17,318,49480,69597.25
110060,2020,Bethesda University,CA,43,42,1,21,4,17,25,22453,73410.31
222831,2020,Angelo State University,TX,1279,1270,9,1221,32,17,1253,19810,49632.36
219949,2020,Cumberland University,TN,633,633,0,572,44,17,616,38392,59163.95
169479,2020,Davenport University,MI,633,633,0,558,58,17,616,31321,56679.53
240426,2020,University of Wisconsin-Superior,WI,276,276,0,135,124,17,259,18731,53835.5
215655,2020,Robert Morris University,PA,565,563,2,433,113,17,546,47724,59274.33
151102,2020,Purdue University Fort Wayne,IN,1388,1386,2,1224,145,17,1369,19224,61940.3
220631,2020,Lincoln Memorial University,TN,229,229,0,117,95,17,212,36365,43510.38
160658,2020,University of Louisiana at Lafayette,LA,2338,2338,0,2219,102,17,2321,22948,47090.8
122506,2020,San Francisco Conservatory of Music,CA,57,57,0,12,29,16,41,69135,74879.37
230995,2020,Norwich University,VT,649,646,3,81,549,16,630,59627,68974.52
169442,2020,College for Creative Studies,MI,334,334,0,250,68,16,318,57085,74293.04
221731,2020,Tennessee Wesleyan University,TN,189,189,0,148,25,16,173,33219,48462.92
228802,2020,The University of Texas at Tyler,TX,1065,1065,0,1038,11,16,1049,20730,53622.93
182290,2020,University of Nevada-Reno,NV,3342,3338,4,2437,885,16,3322,23256,68050.29
219976,2020,Lipscomb University,TN,692,692,0,424,252,16,676,49074,66979.13
221740,2020,The University of Tennessee-Chattanooga,TN,2222,2221,1,2055,151,15,2206,23436,55964.16
170037,2020,Cornerstone University,MI,283,283,0,229,39,15,268,35814,63718.46
128771,2020,Central Connecticut State University,CT,1198,1198,0,1105,78,15,1183,22518,75579.11
169798,2020,Eastern Michigan University,MI,1922,1918,4,1611,292,15,1903,24994,69989
221351,2020,Rhodes College,TN,442,442,0,110,317,15,427,64249,73395.81
139366,2020,Columbus State University,GA,1387,1381,6,1273,93,15,1366,19807,55979.92
217882,2020,Clemson University,SC,4199,4193,6,2333,1845,15,4178,32254,64586.36
218229,2020,Lander University,SC,861,860,1,788,57,15,845,24474,52256.85
199148,2020,University of North Carolina at Greensboro,NC,2432,2419,13,2295,109,15,2404,19179,60658.11
163462,2020,Mount St. Mary's University,MD,647,644,3,358,271,15,629,57867,81781.05
199643,2020,Shaw University,NC,286,286,0,167,105,14,272,29686,53196.27
227526,2020,Prairie View A & M University,TX,1882,1882,0,1667,201,14,1868,25164,57579.55
181215,2020,University of Nebraska at Kearney,NE,833,832,1,757,61,14,818,23319,51335.53
217819,2020,College of Charleston,SC,2052,2049,3,1002,1033,14,2035,29545,66962.7
224147,2020,Texas A & M University-Corpus Christi,TX,1612,1612,0,1547,51,14,1598,22459,54287.8
217235,2020,Johnson & Wales University-Providence,RI,1219,1219,0,206,999,14,1205,51167,68856.12
217402,2020,Providence College,RI,1000,1000,0,100,886,14,986,69407,83293.65
140960,2020,Savannah State University,GA,745,745,0,634,97,14,731,16819,54220.88
236595,2020,Seattle University,WA,805,798,7,355,429,14,784,63439,70785.55
110574,2020,California State University-East Bay,CA,1088,1088,0,1065,9,14,1074,23357,78750.43
181002,2020,Creighton University,NE,1015,1014,1,244,756,14,1000,56120,68443.5
209807,2020,Portland State University,OR,1515,1510,5,1198,298,14,1496,20571,62889.32
198136,2020,Campbell University,NC,676,674,2,522,138,14,660,51131,56906.03
221892,2020,Trevecca Nazarene University,TN,350,346,4,226,106,14,332,34473,59625.44
141334,2020,University of West Georgia,GA,1821,1794,27,1741,39,14,1780,23684,66454.08
181330,2020,Midland University,NE,370,370,0,174,182,14,356,45689,56723.06
163453,2020,Morgan State University,MD,1213,1209,4,639,556,14,1195,23254,63566.62
142115,2020,Boise State University,ID,2870,2870,0,1506,1350,14,2856,21621,58298.66
142285,2020,University of Idaho,ID,1425,1389,36,977,399,13,1376,21525,54125.14
123165,2020,Scripps College,CA,220,220,0,97,110,13,207,77588,79153.99
197869,2020,Appalachian State University,NC,3906,3903,3,3629,261,13,3890,19661,61267.04
172051,2020,Saginaw Valley State University,MI,1383,1383,0,1336,34,13,1370,22353,57827.75
229018,2020,The University of Texas Permian Basin,TX,559,554,5,513,28,13,541,17323,47475.29
151290,2020,Indiana Institute of Technology,IN,456,456,0,258,185,13,443,40161,60972.77
215442,2020,Point Park University,PA,522,522,0,301,208,13,509,45350,54201.1
159416,2020,Louisiana State University-Shreveport,LA,339,339,0,311,15,13,326,19065,47946.96
136330,2020,Palm Beach Atlantic University,FL,526,523,3,312,198,13,510,49839,64221.06
135081,2020,Keiser University-Ft Lauderdale,FL,2304,2271,33,1729,529,13,2258,40713,55699.66
117140,2020,University of La Verne,CA,660,659,1,615,31,13,646,60759,67082.29
198950,2020,Meredith College,NC,372,369,3,327,29,13,356,50390,66301.42
152530,2020,Taylor University,IN,416,416,0,179,225,12,404,48656,68822.46
153269,2020,Drake University,IA,738,738,0,225,501,12,726,57643,70375.31
240277,2020,University of Wisconsin-Green Bay,WI,1269,1269,0,1167,90,12,1257,17509,63413.11
377555,2020,University of Washington-Bothell Campus,WA,985,985,0,959,14,12,973,23189,69752.4
152099,2020,Oakland City University,IN,107,106,1,59,35,12,94,37683,52931.31
212160,2020,Edinboro University of Pennsylvania,PA,645,645,0,535,98,12,633,22036,52799.06
102553,2020,University of Alaska Anchorage,AK,1057,1053,4,977,64,12,1041,18946,72116.59
169248,2020,Central Michigan University,MI,2088,2086,2,1898,177,11,2075,25078,66048.2
206048,2020,Tiffin University,OH,511,473,38,341,121,11,462,41055,59678.08
123554,2020,Saint Mary's College of California,CA,468,467,1,401,55,11,456,69071,84232.87
163976,2020,St. John's College,MD,85,85,0,19,55,11,74,50001,72041.37
110510,2020,California State University-San Bernardino,CA,2286,2286,0,2264,11,11,2275,19114,59070.9
110413,2020,California Lutheran University,CA,516,516,0,424,81,11,505,60668,81648.78
128498,2020,Albertus Magnus College,CT,178,178,0,147,20,11,167,49375,65065.75
218742,2020,University of South Carolina-Upstate,SC,754,748,6,688,49,11,737,23660,54689.19
198561,2020,Gardner-Webb University,NC,471,469,2,260,198,11,458,45333,54757.84
150534,2020,University of Evansville,IN,395,395,0,262,122,11,384,50986,61532.75
162210,2020,Washington Adventist University,MD,89,87,2,51,25,11,76,33721,69837.96
433660,2020,Florida Gulf Coast University,FL,2595,2583,12,2204,368,11,2572,18151,62394.85
155335,2020,Newman University,KS,148,147,1,108,28,11,136,41633,62008.99
213020,2020,Indiana University of Pennsylvania-Main Campus,PA,1881,1881,0,1780,91,10,1871,28442,54158.04
176053,2020,Mississippi College,MS,422,422,0,237,175,10,412,34918,52824.92
198899,2020,Mars Hill University,NC,288,288,0,194,84,10,278,45406,56558.51
180595,2020,Rocky Mountain College,MT,235,235,0,124,101,10,225,40804,51454.11
237066,2020,Whitworth University,WA,607,607,0,425,172,10,597,60359,63739.65
110538,2020,California State University-Chico,CA,2316,2316,0,2281,25,10,2306,25073,61867.44
221953,2020,Tusculum University,TN,278,278,0,184,84,10,268,39440,49705.55
156213,2020,Asbury University,KY,264,264,0,136,118,10,254,42462,61842.48
207847,2020,Southeastern Oklahoma State University,OK,512,512,0,350,152,10,502,16367,41386.98
230834,2020,Castleton University,VT,298,298,0,128,160,10,288,24841,61392.97
173300,2020,Concordia College at Moorhead,MN,498,498,0,330,158,10,488,53819,60523.09
219471,2020,University of South Dakota,SD,1238,1238,0,784,444,10,1228,23016,53799.09
151342,2020,Indiana University-South Bend,IN,805,805,0,768,27,10,795,16667,59249.25
215114,2020,Cairn University-Langhorne,PA,215,213,2,119,84,10,203,41762,69912.01
151306,2020,University of Southern Indiana,IN,1286,1286,0,1121,155,10,1276,20146,57279.45
213367,2020,La Salle University,PA,582,582,0,373,199,10,572,45298,67401.72
207324,2020,Oklahoma Christian University,OK,359,358,1,210,138,10,348,37015,63431.55
217907,2020,Coker University,SC,244,234,10,171,53,10,224,42395,49143.33
237118,2020,Alderson Broaddus University,WV,225,225,0,56,159,10,215,42676,44559.33
461795,2020,North American University,TX,152,152,0,124,18,10,142,20685,64276.692131199976
162283,2020,Coppin State University,MD,301,300,1,241,49,10,290,17787,54222.17
226833,2020,Midwestern State University,TX,800,800,0,764,27,9,791,19972,57712.44
482149,2020,Augusta University,GA,1028,1027,1,963,55,9,1018,20115,64276.692131199976
129242,2020,Fairfield University,CT,1118,1118,0,223,886,9,1109,67080,93458.99
199698,2020,St. Andrews University,NC,284,284,0,111,164,9,275,44686,64861.88
140447,2020,Mercer University,GA,888,888,0,767,112,9,879,52940,67164.94
204468,2020,Notre Dame College,OH,283,281,2,205,67,9,272,43425,60228.48
226091,2020,Lamar University,TX,1472,1472,0,1431,32,9,1463,20362,53474.77
207403,2020,Oklahoma Baptist University,OK,417,417,0,270,138,9,408,42983,59289.35
112084,2020,San Diego Christian College,CA,84,83,1,56,18,9,74,47755,66943.92
125763,2020,Whittier College,CA,239,238,1,176,54,8,230,61052,73825.46
199281,2020,University of North Carolina at Pembroke,NC,901,885,16,823,54,8,877,15952,49520.51
366711,2020,California State University-San Marcos,CA,2255,2255,0,2218,29,8,2247,22531,72827.06
169910,2020,Ferris State University,MI,1544,1542,2,1421,113,8,1534,23106,61040.62
129941,2020,University of New Haven,CT,1371,1368,3,545,815,8,1360,58438,77310.15
138868,2020,Point University,GA,152,152,0,109,35,8,144,34160,69033.68
156082,2020,Washburn University,KS,660,605,55,583,14,8,597,20011,57541.98
154101,2020,Northwestern College,IA,273,273,0,158,107,8,265,45760,58600.59
199218,2020,University of North Carolina Wilmington,NC,2025,2011,14,1738,265,8,2003,24837,62176.12
210331,2020,Corban University,OR,208,199,9,115,76,8,191,45919,61069.68
155900,2020,Southwestern College,KS,226,225,1,71,146,8,217,46869,58156.66
217536,2020,Salve Regina University,RI,549,549,0,84,457,8,541,61072,81126.67
156745,2020,Georgetown College,KY,426,426,0,369,49,8,418,53196,56937.11
130183,2020,Post University,CT,1657,1657,0,224,1425,8,1649,30161,67090.63
200332,2020,North Dakota State University-Main Campus,ND,2307,2306,1,809,1489,8,2298,22201,55831.54
107071,2020,Henderson State University,AR,563,563,0,495,60,8,555,23005,45548.96
218654,2020,University of South Carolina Beaufort,SC,358,350,8,297,45,8,342,24235,60345.78
234827,2020,Central Washington University,WA,1723,1721,2,1597,116,8,1713,24008,63170.67
169327,2020,Cleary University,MI,120,120,0,104,8,8,112,35998,81153.11
218070,2020,Furman University,SC,514,512,2,147,357,8,504,67299,71867.28
180179,2020,Montana State University Billings,MT,504,504,0,452,45,7,497,16755,48720.57
180984,2020,Concordia University-Nebraska,NE,329,329,0,158,164,7,322,45672,60450.28
238661,2020,Edgewood College,WI,290,290,0,242,41,7,283,44826,68115.77
150163,2020,Butler University,IN,1104,1103,1,482,614,7,1096,61623,71968.39
152567,2020,Trine University,IN,632,631,1,314,310,7,624,47142,60275.33
486901,2020,Milligan University,TN,198,198,0,122,69,7,191,46072,64276.692131199976
131450,2020,Gallaudet University,DC,152,152,0,0,145,7,145,38892,65746.56
174491,2020,University of Northwestern-St Paul,MN,368,368,0,279,82,7,361,43817,70065.41
231059,2020,Saint Michael's College,VT,374,373,1,72,294,7,366,61892,75427.87
112075,2020,Concordia University-Irvine,CA,311,311,0,207,97,7,304,53235,79890.85
219833,2020,Christian Brothers University,TN,283,283,0,208,68,7,276,43939,61225.91
134079,2020,Florida Southern College,FL,675,610,65,388,215,7,603,52794,60789.21
157809,2020,Thomas More University,KY,411,411,0,257,147,7,404,42003,64733.74
175856,2020,Jackson State University,MS,623,623,0,210,406,7,616,24570,43401.54
225247,2020,Hardin-Simmons University,TX,454,452,2,431,14,7,445,42530,59593.97
154013,2020,Mount Mercy University,IA,225,223,2,161,55,7,216,48189,61693.27
107512,2020,Ouachita Baptist University,AR,389,389,0,241,141,7,382,40200,61306.22
133951,2020,Florida International University,FL,3763,3727,36,3598,122,7,3720,19384,58110.89
199069,2020,University of Mount Olive,NC,287,286,1,212,67,7,279,32055,51727.18
156620,2020,Eastern Kentucky University,KY,2271,2270,1,1920,343,7,2263,23384,47617.36
138293,2020,Webber International University,FL,286,285,1,227,51,7,278,42702,55372.47
214041,2020,Millersville University of Pennsylvania,PA,1160,1160,0,1035,118,7,1153,27526,65479.69
155520,2020,MidAmerica Nazarene University,KS,209,209,0,99,104,6,203,48863,69737.68
217864,2020,Citadel Military College of South Carolina,SC,582,582,0,328,248,6,576,30022,66736.53
138600,2020,Agnes Scott College,GA,274,274,0,180,88,6,268,55403,69580.95
238430,2020,Cardinal Stritch University,WI,77,77,0,60,11,6,71,44172,64348.07
207971,2020,University of Tulsa,OK,491,474,17,274,194,6,468,58637,62928.78
206622,2020,Xavier University,OH,1315,1314,1,606,702,6,1308,58260,68472.8
163338,2020,University of Maryland Eastern Shore,MD,469,465,4,335,124,6,459,24348,66039.83
239071,2020,Maranatha Baptist University,WI,126,121,5,39,76,6,115,27793,62743.18
213349,2020,Kutztown University of Pennsylvania,PA,1532,1532,0,1304,222,6,1526,28414,67783.54
205443,2020,Shawnee State University,OH,627,625,2,555,64,6,619,16327,43961.17
214175,2020,Muhlenberg College,PA,517,517,0,154,357,6,511,69413,89504.61
228705,2020,Texas A & M University-Kingsville,TX,1055,1055,0,1041,8,6,1049,22645,45266.24
207856,2020,Southwestern Christian University,OK,136,136,0,98,32,6,130,28315,50467
220215,2020,Freed-Hardeman University,TN,350,350,0,215,129,6,344,35099,53404.21
217688,2020,Charleston Southern University,SC,604,604,0,486,112,6,598,40177,57179.15
125897,2020,Woodbury University,CA,140,137,3,103,28,6,131,55032,60713.37
139311,2020,Clayton  State University,GA,795,795,0,773,16,6,789,18374,65444.71
153162,2020,Cornell College,IA,290,289,1,70,213,6,283,58201,67428.42
199157,2020,North Carolina Central University,NC,1232,1167,65,889,272,6,1161,24075,57501.19
221838,2020,Tennessee State University,TN,1703,1703,0,680,1017,6,1697,22509,53809.87
239318,2020,Milwaukee School of Engineering,WI,573,573,0,341,226,6,567,53885,68757.09
240189,2020,University of Wisconsin-Whitewater,WI,2055,2055,0,1729,320,6,2049,18252,67955.05
197911,2020,Barton College,NC,287,287,0,223,58,6,281,46539,54814.93
175272,2020,Winona State University,MN,1274,1274,0,850,419,5,1269,22003,68678.3
228468,2020,Southwestern Adventist University,TX,138,138,0,91,42,5,133,31865,57388.77
110486,2020,California State University-Bakersfield,CA,1416,1416,0,1392,19,5,1411,18661,53982.7
156286,2020,Bellarmine University,KY,573,573,0,397,171,5,568,56319,65601.28
216366,2020,Thomas Jefferson University,PA,641,631,10,370,256,5,626,60290,66565.04
204006,2020,Miami University-Hamilton,OH,473,472,1,466,1,5,467,16237,72182.76
240374,2020,University of Wisconsin-Parkside,WI,541,541,0,475,61,5,536,16320,64274.59
209612,2020,Pacific University,OR,348,348,0,146,197,5,343,62157,64591.02
217925,2020,Columbia International University,SC,154,154,0,95,54,5,149,36979,64434.93
218539,2020,Presbyterian College,SC,313,312,1,211,96,5,307,53720,62666.83
227881,2020,Sam Houston State University,TX,2843,2843,0,2808,30,5,2838,22885,63900.24
207661,2020,Rogers State University,OK,494,494,0,476,13,5,489,20029,50487.79
170967,2020,Rochester University,MI,196,196,0,181,10,5,191,33013,72043.03
141185,2020,Toccoa Falls College,GA,205,204,1,154,45,5,199,37297,59357.86
208822,2020,George Fox University,OR,471,470,1,208,257,5,465,51439,65616.22
201104,2020,Ashland University,OH,437,437,0,397,35,5,432,33775,64491.65
162007,2020,Bowie State University,MD,970,963,7,791,167,5,958,22891,77046.6
239716,2020,Saint Norbert College,WI,458,458,0,357,96,5,453,51383,71321.9
220701,2020,Martin Methodist College,TN,186,186,0,134,47,5,181,40576,49230.32
240417,2020,University of Wisconsin-Stout,WI,1332,1332,0,800,527,5,1327,19704,65020.23
217873,2020,Claflin University,SC,501,501,0,435,62,4,497,33777,45792.28
377564,2020,University of Washington-Tacoma Campus,WA,621,621,0,607,10,4,617,21705,69752.4
217518,2020,Roger Williams University,RI,999,999,0,152,843,4,995,54865,84094.11
215798,2020,Saint Vincent College,PA,360,360,0,269,87,4,356,50140,54143.22
182458,2020,Sierra Nevada University,NV,42,41,1,9,28,4,37,50040,71252.07
238616,2020,Concordia University-Wisconsin,WI,533,521,12,340,177,4,517,45936,64715.84
235316,2020,Gonzaga University,WA,1052,1020,32,467,549,4,1016,61761,67848.44
216038,2020,Slippery Rock University of Pennsylvania,PA,1463,1463,0,1317,142,4,1459,24600,54113.09
161457,2020,University of New England,ME,564,564,0,133,427,4,560,56844,64934.4
225414,2020,University of Houston-Clear Lake,TX,363,363,0,359,0,4,359,25567,67975.01
204185,2020,University of Mount Union,OH,550,550,0,446,100,4,546,44497,61044.98
181738,2020,Union College,NE,124,110,14,20,86,4,106,36243,60804.76
225432,2020,University of Houston-Downtown,TX,1491,1491,0,1481,6,4,1487,20995,59551.33
445708,2020,Johnson & Wales University-Charlotte,NC,483,483,0,170,309,4,479,50200,68856.12
162061,2020,Capitol Technology University,MD,63,63,0,47,12,4,59,40538,73053.75
240462,2020,University of Wisconsin-Platteville,WI,1389,1389,0,1058,327,4,1385,18670,61602.16
128744,2020,University of Bridgeport,CT,310,310,0,170,136,4,306,53853,63241.6
213996,2020,Messiah University,PA,614,614,0,398,212,4,610,49864,71914.01
225399,2020,Houston Baptist University,TX,668,665,3,632,29,4,661,43638,72476.33
203517,2020,Kent State University at Kent,OH,3870,3811,59,3087,720,4,3807,25836,59479.84
118888,2020,Mills College,CA,130,130,0,97,29,4,126,48360,71756.45
121309,2020,Point Loma Nazarene University,CA,554,554,0,405,145,4,550,53045,71269.62
225575,2020,Huston-Tillotson University,TX,169,169,0,157,8,4,165,24148,57117.25
153375,2020,Grand View University,IA,294,294,0,219,71,4,290,39864,62140.86
206862,2020,Southern Nazarene University,OK,259,259,0,171,84,4,255,38327,57571.98
130493,2020,Southern Connecticut State University,CT,1081,1081,0,1030,47,4,1077,25413,74581.97
160904,2020,Xavier University of Louisiana,LA,712,709,3,242,463,4,705,36391,55657.89
204194,2020,Mount Vernon Nazarene University,OH,345,345,0,299,42,4,341,43341,60597.42
154235,2020,Saint Ambrose University,IA,521,421,100,160,257,4,417,46894,63314.56
200004,2020,Western Carolina University,NC,1823,1801,22,1513,284,4,1797,18462,56230.92
201195,2020,Baldwin Wallace University,OH,659,659,0,491,165,3,656,48655,66257.54
160621,2020,Southern University and A & M College,LA,1370,1370,0,976,391,3,1367,23592,45854.37
216278,2020,Susquehanna University,PA,573,572,1,336,233,3,569,64760,72676.24
153320,2020,Faith Baptist Bible College and Theological Seminary,IA,95,95,0,30,62,3,92,28069,57604.15
212133,2020,Eastern University,PA,372,372,0,234,135,3,369,48828,68457.57
159009,2020,Grambling State University,LA,1241,1241,0,668,570,3,1238,24332,44602.47
174358,2020,Minnesota State University Moorhead,MN,730,724,6,499,222,3,721,22525,54641.42
155089,2020,Friends University,KS,212,212,0,131,78,3,209,39879,60343.56
218733,2020,South Carolina State University,SC,479,479,0,409,67,3,476,30015,48129.81
213303,2020,Keystone College,PA,232,232,0,155,74,3,229,39200,51740.58
215132,2020,University of the Sciences,PA,317,317,0,189,125,3,314,43968,72732.06
209603,2020,Pacific Northwest College of Art,OR,89,89,0,32,54,3,86,54345,63108.93
141237,2020,Truett McConnell University,GA,271,271,0,244,24,3,268,33299,62186.38
207458,2020,Oklahoma City University,OK,325,323,2,126,194,3,320,44942,59190.63
117627,2020,La Sierra University,CA,282,281,1,260,18,3,278,45629,63313.83
480781,2020,California Miramar University,CA,24,24,0,15,6,3,21,20578,64276.692131199976
202903,2020,Gods Bible School and College,OH,48,48,0,20,25,3,45,15632,53235.79
236133,2020,Northwest University,WA,159,159,0,124,32,3,156,45095,71872.75
142461,2020,Northwest Nazarene University,ID,283,282,1,148,131,3,279,42068,59470.41
238476,2020,Carthage College,WI,724,724,0,261,460,3,721,59175,76392.24
125231,2020,Walden University,MN,155,155,0,2,150,3,152,37686.031269160027,62475.08
237330,2020,Concord University,WV,383,383,0,305,75,3,380,16824,41360.98
409698,2020,California State University-Monterey Bay,CA,879,879,0,854,22,3,876,23389,70802.17
216010,2020,Shippensburg University of Pennsylvania,PA,1219,1219,0,1109,107,3,1216,29182,63560.54
154688,2020,Baker University,KS,224,224,0,162,59,3,221,44473,67758.92
215743,2020,Saint Francis University,PA,335,335,0,252,80,3,332,54101,55181.27
199184,2020,University of North Carolina School of the Arts,NC,219,215,4,100,112,3,212,21755,68862.71
226383,2020,Lubbock Christian University,TX,280,280,0,255,22,3,277,37198,51468.15
152336,2020,University of Saint Francis-Fort Wayne,IN,404,404,0,359,42,3,401,40759,63802.5
181020,2020,Doane University,NE,268,267,1,173,91,3,264,50470,57123.16
130314,2020,University of Saint Joseph,CT,185,185,0,163,19,3,182,50959,74607
236328,2020,University of Puget Sound,WA,393,393,0,113,277,3,390,68072,72356.02
199032,2020,Montreat College,NC,223,217,6,125,90,2,215,40841,61225.9
210492,2020,Bryn Athyn College of the New Church,PA,53,48,5,33,13,2,46,36254,96737.95
203085,2020,Heidelberg University,OH,322,322,0,269,51,2,320,44381,61648.4
173160,2020,Bethel University,MN,479,479,0,366,111,2,477,52723,77038.37
129215,2020,Eastern Connecticut State University,CT,841,841,0,773,66,2,839,27425,76020.15
163046,2020,Loyola University Maryland,MD,1008,1008,0,300,706,2,1006,67196,92129.84
221661,2020,Southern Adventist University,TN,493,480,13,105,373,2,478,35820,60144.84
152600,2020,Valparaiso University,IN,637,637,0,281,354,2,635,53847,72576.06
229179,2020,Texas Woman's University,TX,1130,1130,0,1104,24,2,1128,19418,69739.2
206604,2020,Wright State University-Main Campus,OH,1181,1173,8,1122,49,2,1171,23009,61970.64
133650,2020,Florida Agricultural and Mechanical University,FL,1040,1035,5,772,261,2,1033,23312,52786.24
151379,2020,Indiana University-Southeast,IN,800,800,0,631,167,2,798,17421,57669.69
154712,2020,Benedictine College,KS,575,571,4,140,429,2,569,46309,64485.18
198613,2020,Guilford College,NC,372,372,0,272,98,2,370,53479,63141.25
202170,2020,Columbus College of Art and Design,OH,223,221,2,148,71,2,219,49217,65843.21
131399,2020,University of the District of Columbia,DC,391,387,4,335,50,2,385,22638,51576.54
240471,2020,University of Wisconsin-River Falls,WI,1088,1088,0,488,598,2,1086,17971,69159.98
215105,2020,The University of the Arts,PA,297,297,0,110,185,2,295,65881,75947.63
211556,2020,Chatham University,PA,260,259,1,177,80,2,257,52968,56097.18
223117,2020,Baptist Missionary Association Theological Seminary,TX,4,3,1,0,1,2,1,37686.031269160027,48842.7
219082,2020,Dakota State University,SD,388,388,0,241,145,2,386,22365,52093.19
181783,2020,Wayne State College,NE,813,813,0,691,120,2,811,19521,51810.1
210429,2020,Western Oregon University,OR,722,721,1,546,173,2,719,22810,59410.15
214272,2020,Neumann University,PA,412,412,0,273,137,2,410,50640,69149.16
115728,2020,Holy Names University,CA,135,134,1,127,5,2,132,57486,72379.02
211893,2020,Curtis Institute of Music,PA,13,13,0,1,10,2,11,22192,70406
212656,2020,Geneva College,PA,275,275,0,174,99,2,273,38941,55668.91
203757,2020,Lourdes University,OH,182,179,3,112,65,2,177,37498,59351.8
236230,2020,Pacific Lutheran University,WA,589,588,1,446,140,2,586,56830,65366.76
155627,2020,Ottawa University-Ottawa,KS,201,201,0,73,126,2,199,47369,65346.8
209241,2020,Mount Angel Seminary,OR,4,4,0,0,2,2,2,39700,59323.69
213613,2020,Lock Haven University,PA,617,617,0,590,25,2,615,25916,55815.84
212197,2020,Elizabethtown College,PA,405,405,0,277,126,2,403,44978,70213.56
217721,2020,Benedict College,SC,356,355,1,134,219,2,353,28000,49336.04
134811,2020,AI Miami International University of Art and Design,FL,110,110,0,97,11,2,108,27974,57565.03
199102,2020,North Carolina A & T State University,NC,2136,2108,28,1523,583,2,2106,18348,56398.61
449870,2020,University of the West,CA,7,7,0,4,1,2,5,24236,64276.692131199976
449764,2020,Visible Music College,TN,35,35,0,8,25,2,33,32644,64276.692131199976
441937,2020,California State University-Channel Islands,CA,632,632,0,629,1,2,630,25150,78662.36
174817,2020,Saint Mary's University of Minnesota,MN,239,239,0,137,100,2,237,49200,70833.22
484905,2020,University of North Texas at Dallas,TX,434,434,0,431,2,1,433,18930,64276.692131199976
138947,2020,Clark Atlanta University,GA,786,784,2,186,597,1,783,39194,60451.55
229063,2020,Texas Southern University,TX,724,724,0,597,126,1,723,23173,53781.71
214069,2020,Misericordia University,PA,354,354,0,243,110,1,353,48844,56588.57
226587,2020,McMurry University,TX,227,226,1,220,5,1,225,41764,52571.87
218645,2020,University of South Carolina Aiken,SC,542,534,8,475,58,1,533,20735,53123.12
174127,2020,Minneapolis College of Art and Design,MN,154,154,0,92,61,1,153,53010,70094.27
137953,2020,Trinity Baptist College,FL,80,80,0,68,11,1,79,22571,58249.91
155681,2020,Pittsburg State University,KS,803,801,2,502,298,1,800,18657,50242.27
239390,2020,Mount Mary University,WI,139,139,0,126,12,1,138,44284,62361.14
217776,2020,Southern Wesleyan University,SC,194,194,0,117,76,1,193,35949,54696.17
117557,2020,Lincoln University,CA,5,5,0,4,0,1,4,37686.031269160027,76284.11
124487,2020,Epic Bible College,CA,7,7,0,6,0,1,6,37686.031269160027,63747.56
157793,2020,Sullivan University,KY,403,403,0,291,111,1,402,28469,55475.64
175005,2020,St Catherine University,MN,327,327,0,268,58,1,326,50794,71786.79
120537,2020,Hope International University,CA,93,91,2,81,9,1,90,46231,71774.01
198543,2020,Fayetteville State University,NC,736,710,26,658,51,1,709,16623,49808.38
161217,2020,University of Maine at Augusta,ME,366,366,0,335,30,1,365,16948,48750.5
445133,2020,American InterContinental University-Houston,TX,16,16,0,13,2,1,15,21745,58772.86
123572,2020,Sonoma State University,CA,913,913,0,900,12,1,912,26537,75511.05
237367,2020,Fairmont State University,WV,800,792,8,685,106,1,791,17639,42179.08
213400,2020,Lancaster Bible College,PA,164,164,0,116,47,1,163,36544,64787.49
158477,2020,Centenary College of Louisiana,LA,153,153,0,95,57,1,152,55300,58549.24
219383,2020,University of Sioux Falls,SD,263,263,0,114,148,1,262,30472,57493.05
198303,2020,Chowan University,NC,238,230,8,111,118,1,229,37161,53634.23
128780,2020,Charter Oak State College,CT,43,43,0,30,12,1,42,16369,63157.4
173045,2020,Augsburg University,MN,563,563,0,519,43,1,562,54069,72224.74
199999,2020,Winston-Salem State University,NC,1007,997,10,831,165,1,996,20382,54716.68
490081,2020,America Evangelical University,CA,7,7,0,4,2,1,6,11420,64276.692131199976
245953,2020,Mid-America Christian University,OK,172,172,0,135,36,1,171,28755,51555.64
211024,2020,Clarks Summit University,PA,93,92,1,42,49,1,91,33826,62401.75
216357,2020,Thiel College,PA,250,249,1,172,76,1,248,48566,54604.75
111045,2020,Haven University,CA,3,3,0,1,1,1,2,37686.031269160027,64276.692131199976
433387,2020,Western Governors University,UT,100,100,0,8,91,1,99,13790,62039.21
228325,2020,Southwestern Assemblies of God University,TX,317,317,0,207,109,1,316,34268,59789.49
229814,2020,West Texas A & M University,TX,1254,1214,40,1088,125,1,1213,20456,51385.91
133872,2020,AdventHealth University,FL,99,99,0,84,14,1,98,33648,60028.37
129534,2020,Holy Apostles College and Seminary,CT,17,17,0,1,15,1,16,37686.031269160027,64276.692131199976
168847,2020,Baker College,MI,605,605,0,560,44,1,604,19593,59405.88
211088,2020,Arcadia University,PA,478,475,3,296,178,1,474,59684,72830.78
141325,2020,Wesleyan College,GA,139,134,5,127,6,1,133,34952,57826.42
117104,2020,Life Pacific University,CA,77,77,0,62,14,1,76,29158,65850.07
132471,2020,Barry University,FL,645,622,23,401,220,1,621,47118,58621.88
134237,2020,Full Sail University,FL,4062,4026,36,1011,3014,1,4025,35865,66113.73
201371,2020,Bluffton University,OH,195,195,0,157,37,1,194,48205,59827.57
151801,2020,Indiana Wesleyan University-Marion,IN,567,567,0,366,200,1,566,39347,62930.13
206279,2020,Union Institute & University,OH,9,9,0,0,8,1,8,31656,59714.64
181446,2020,Nebraska Wesleyan University,NE,427,427,0,342,84,1,426,48718,59199.51
490045,2020,Presbyterian Theological Seminary in America,CA,3,3,0,1,1,1,2,37686.031269160027,64276.692131199976
139764,2020,Georgia Southwestern State University,GA,477,477,0,454,22,1,476,19125,49591.36
237792,2020,Shepherd University,WV,523,523,0,349,173,1,522,17759,62744.63
449339,2020,American Public University System,WV,1805,1738,67,7,1730,1,1737,16569,64276.692131199976
475608,2020,Criswell College,TX,20,20,0,18,1,1,19,23142,64276.692131199976
151777,2020,Manchester University,IN,350,350,0,277,72,1,349,45489,60877.57
219240,2020,Sioux Falls Seminary,SD,16,16,0,9,6,1,15,37686.031269160027,64276.692131199976
154350,2020,Simpson College,IA,295,295,0,224,70,1,294,53845,60274.33
150941,2020,Huntington University,IN,253,253,0,161,91,1,252,38461,63046.08
213251,2020,Juniata College,PA,328,302,26,199,102,1,301,61807,62290.9
465812,2020,Independence University,UT,1892,1892,0,26,1865,1,1891,31805,64276.692131199976
198215,2020,Catawba College,NC,365,351,14,238,112,1,350,44235,60564.51
132879,2020,Johnson University Florida,FL,38,38,0,37,0,1,37,27611,59004.31
157757,2020,Spalding University,KY,138,121,17,101,19,1,120,38163,55916.29
157058,2020,Kentucky State University,KY,568,568,0,214,353,1,567,16885,51636.62
139861,2020,Georgia College & State University,GA,1363,1363,0,1348,14,1,1362,28707,68382.02
216764,2020,West Chester University of Pennsylvania,PA,2796,2795,1,2434,360,1,2794,26114,74655.83
460349,2020,Johnson & Wales University-Online,RI,43,43,0,3,39,1,42,25224,64276.692131199976
219790,2020,Bryan College-Dayton,TN,216,213,3,164,48,1,212,38061,56756.79
117672,2020,Southern California University of Health Sciences,CA,6,6,0,6,0,0,6,37686.031269160027,64276.692131199976
131803,2020,Strayer University-District of Columbia,DC,45,45,0,26,19,0,45,37686.031269160027,66472.61
183257,2020,Granite State College,NH,70,70,0,49,21,0,70,18834,59743.94
202514,2020,Defiance College,OH,217,217,0,106,111,0,217,46420,61079.24
214166,2020,Mount Aloysius College,PA,243,242,1,211,31,0,242,36886,45385.58
401223,2020,World Mission University,CA,22,18,4,13,5,0,18,22025,62541
442930,2020,University of Antelope Valley,CA,91,91,0,80,11,0,91,37686.031269160027,57306.38
225201,2020,Hallmark University,TX,195,195,0,186,9,0,195,37686.031269160027,55040.41
150455,2020,Earlham College,IN,147,129,18,35,94,0,129,61156,66410.88
422695,2020,Pacific College,CA,2,2,0,2,0,0,2,37686.031269160027,73126.5
480985,2020,Midwives College of Utah,UT,5,5,0,0,5,0,5,24516,64276.692131199976
430184,2020,Strayer University-Maryland,MD,123,123,0,109,14,0,123,28284,64276.692131199976
203465,2020,Kent State University at Stark,OH,528,527,1,526,1,0,527,12914,59479.84
408844,2020,Florida National University-Main Campus,FL,495,492,3,475,17,0,492,28378,51661.46
238263,2020,Madison Area Technical College,WI,1430,1425,5,1399,26,0,1425,14210,64533.76
113582,2020,Design Institute of San Diego,CA,2,2,0,2,0,0,2,42928,71383.01
213774,2020,Manor College,PA,142,141,1,136,5,0,141,25964,60787.72
175421,2020,Belhaven University,MS,278,275,3,133,142,0,275,35975,57705.44
442356,2020,Pennsylvania College of Health Sciences,PA,114,114,0,110,4,0,114,38003,63119.07
201061,2020,Art Academy of Cincinnati,OH,77,77,0,51,26,0,77,44864,69050.69
140234,2020,LaGrange College,GA,174,174,0,140,34,0,174,46034,61341.56
173957,2020,Mayo Clinic College of Medicine and Science,MN,36,36,0,25,11,0,36,37686.031269160027,62262.3
237899,2020,West Virginia State University,WV,282,282,0,225,57,0,282,19144,48790.55
111188,2020,California State University Maritime Academy,CA,186,186,0,167,19,0,186,28149,78248.99
134510,2020,Hobe Sound Bible College,FL,25,21,4,9,12,0,21,14488,50360.1
216047,2020,Saint Charles Borromeo Seminary-Overbrook,PA,5,5,0,3,2,0,5,41324,58077.31
132408,2020,The Baptist College of Florida,FL,28,28,0,21,7,0,28,19926,50305.97
180832,2020,Clarkson College,NE,39,39,0,30,9,0,39,24917,61065.74
204176,2020,Mount Carmel College of Nursing,OH,68,68,0,68,0,0,68,21615,68565.22
484631,2020,University of Phoenix-California,CA,3,3,0,3,0,0,3,18184,64276.692131199976
160630,2020,Southern University at New Orleans,LA,193,193,0,183,10,0,193,16762,43920.92
111966,2020,Charles R Drew University of Medicine and Science,CA,30,29,1,25,4,0,29,33171,55906.67
482635,2020,DeVry University-Texas,TX,7,7,0,7,0,0,7,33151,64276.692131199976
119605,2020,National University,CA,18,17,1,15,2,0,17,26208,64760.95
216667,2020,Washington & Jefferson College,PA,338,335,3,234,101,0,335,62814,61376.37
457226,2020,Horizon University,IN,6,6,0,6,0,0,6,37686.031269160027,64276.692131199976
140818,2020,Piedmont University,GA,249,249,0,203,46,0,249,40949,58219.12
224527,2020,East Texas Baptist University,TX,403,403,0,348,55,0,403,38749,56363.11
216852,2020,Widener University,PA,600,594,6,329,265,0,594,62831,69397.52
459851,2020,Herzing University-Brookfield,WI,77,77,0,75,2,0,77,29268,64276.692131199976
163532,2020,Ner Israel Rabbinical College,MD,49,47,2,30,17,0,47,23250,59120.36
217059,2020,York College of Pennsylvania,PA,847,846,1,495,351,0,846,32801,73378.65
159656,2020,Loyola University New Orleans,LA,767,753,14,342,411,0,753,54417,67759.61
449898,2020,South University-Tampa,FL,15,15,0,13,2,0,15,28397,64276.692131199976
213011,2020,Immaculata University,PA,239,239,0,153,86,0,239,44036,74355.43
217420,2020,Rhode Island College,RI,819,819,0,694,125,0,819,17761,61569.63
172033,2020,Sacred Heart Major Seminary,MI,2,1,1,1,0,0,1,36882,73787.59
152390,2020,Saint Mary's College,IN,392,389,3,136,253,0,389,58956,72879.94
106245,2020,University of Arkansas at Little Rock,AR,516,516,0,450,66,0,516,20416,51732.17
227331,2020,Our Lady of the Lake University,TX,295,293,2,287,6,0,293,40753,52505.04
224554,2020,Texas A & M University-Commerce,TX,779,774,5,757,17,0,774,22575,57562.14
457299,2020,Angeles College,CA,35,35,0,35,0,0,35,37686.031269160027,64276.692131199976
205124,2020,Rabbinical College Telshe,OH,15,15,0,5,10,0,15,20200,60972.72
449038,2020,Strayer University-Florida,FL,110,110,0,86,24,0,110,28284,64276.692131199976
123651,2020,Vanguard University of Southern California,CA,555,555,0,495,60,0,555,48086,75891.29
488031,2020,Abraham Lincoln University,CA,3,3,0,2,1,0,3,37686.031269160027,64276.692131199976
230056,2020,Broadview University-West Jordan,UT,45,45,0,42,3,0,45,27859,70004.7
217624,2020,Allen University,SC,173,173,0,111,62,0,173,24695,49460.71
203368,2020,John Carroll University,OH,631,631,0,419,212,0,631,57651,68368.11
489937,2020,Carolina University,NC,75,70,5,45,25,0,70,22830,64276.692131199976
139719,2020,Fort Valley State University,GA,1002,750,252,681,69,0,750,20264,53364.82
151810,2020,Martin University,IN,20,20,0,20,0,0,20,23393,51133.47
372073,2020,Fremont College,CA,60,60,0,59,1,0,60,37686.031269160027,62794.03
243823,2020,Parker University,TX,41,41,0,38,3,0,41,31420,69941.77
212832,2020,Gwynedd Mercy University,PA,197,197,0,163,34,0,197,47646,72929.99
173328,2020,Concordia University-Saint Paul,MN,396,395,1,333,62,0,395,32686,71270.22
247773,2020,Yeshiva Gedolah of Greater Detroit,MI,13,13,0,12,1,0,13,15067,63218.7
201548,2020,Capital University,OH,512,512,0,483,29,0,512,47719,64246.32
168786,2020,Aquinas College,MI,280,280,0,243,37,0,280,43921,64829.33
140340,2020,Herzing University-Atlanta,GA,64,64,0,62,2,0,64,29587,57868.59
156471,2020,Galen College of Nursing-Louisville,KY,269,269,0,221,48,0,269,37686.031269160027,54499.36
174154,2020,Herzing University-Minneapolis,MN,78,78,0,77,1,0,78,28018,71504.15
206835,2020,Oklahoma Wesleyan University,OK,168,166,2,82,84,0,166,40883,51169.37
210304,2020,Warner Pacific University,OR,65,62,3,54,8,0,62,32176,63798.34
203845,2020,Marietta College,OH,338,334,4,245,89,0,334,49601,58715.65
235167,2020,The Evergreen State College,WA,228,228,0,169,59,0,228,24371,63843.36
151786,2020,Marian University,IN,460,453,7,386,67,0,453,49112,65206.92
119775,2020,Newschool of Architecture and Design,CA,30,29,1,23,6,0,29,50284,67862.5
236577,2020,Seattle Pacific University,WA,655,649,6,423,226,0,649,60834,72206.46
180814,2020,Bellevue University,NE,139,62,77,26,36,0,62,22961,63424.91
131113,2020,Wilmington University,DE,625,619,6,222,397,0,619,18524,66924.87
482486,2020,DeVry University-Indiana,IN,4,4,0,4,0,0,4,24764,64276.692131199976
174020,2020,Metropolitan State University,MN,150,150,0,146,4,0,150,22819,69981.95
213783,2020,Mansfield University of Pennsylvania,PA,424,424,0,357,67,0,424,24278,51271.33
114813,2020,Fresno Pacific University,CA,195,192,3,180,12,0,192,43317,53503.12
219000,2020,Augustana University,SD,323,323,0,154,169,0,323,47710,60196.68
480198,2020,Warner Pacific University Professional and Graduate Studies,OR,18,17,1,15,2,0,17,21072,64276.692131199976
150172,2020,Calumet College of Saint Joseph,IN,141,140,1,99,41,0,140,26540,57573.54
157289,2020,University of Louisville,KY,2866,2855,11,2191,664,0,2855,28247,59042.66
441636,2020,American Institute of Alternative Medicine,OH,7,7,0,7,0,0,7,31136,58848.36
481058,2020,Grace Mission University,CA,2,2,0,2,0,0,2,18621,64276.692131199976
458955,2020,Strayer University-Mississippi,MS,37,37,0,33,4,0,37,37686.031269160027,64276.692131199976
119173,2020,Mount Saint Mary's University,CA,370,369,1,361,8,0,369,57689,59943.9
482431,2020,DeVry University-California,CA,43,43,0,41,2,0,43,35697,64276.692131199976
211981,2020,Delaware Valley University,PA,421,421,0,218,203,0,421,56828,74767.83
224004,2020,Concordia University Texas,TX,220,220,0,210,10,0,220,47251,72128.5
174437,2020,North Central University,MN,209,198,11,98,100,0,198,37644,65000.36
110097,2020,Biola University,CA,715,700,15,469,231,0,700,58012,75484.4
214883,2020,Peirce College,PA,13,13,0,8,5,0,13,18260,49493.53
475398,2020,Catholic Distance University,WV,5,5,0,0,5,0,5,37686.031269160027,64276.692131199976
438586,2020,American InterContinental University-Atlanta,GA,124,124,0,119,5,0,124,21048,58772.86
118541,2020,Marymount California University,CA,98,98,0,85,13,0,98,51791,73970.25
440828,2020,Oregon State University-Cascades Campus,OR,161,161,0,134,27,0,161,25945,60312.67
133979,2020,Florida Memorial University,FL,305,305,0,247,58,0,305,28157,48349.61
217305,2020,New England Institute of Technology,RI,381,378,3,162,216,0,378,45601,64106.73
447263,2020,AmeriTech College-Draper,UT,91,91,0,88,3,0,91,26144,62933.79
209287,2020,Multnomah University,OR,48,48,0,18,30,0,48,42743,65799
204200,2020,Mount Saint Joseph University,OH,266,266,0,187,79,0,266,39248,64120.45
207157,2020,Randall University,OK,36,31,5,18,13,0,31,27838,51563.32
451103,2020,Miami Regional University,FL,251,251,0,251,0,0,251,37686.031269160027,64276.692131199976
484710,2020,University of Phoenix-Nevada,NV,1,1,0,1,0,0,1,37686.031269160027,64276.692131199976
173452,2020,Martin Luther College,MN,185,185,0,24,161,0,185,27230,64939.16
204617,2020,Ohio Dominican University,OH,205,196,9,184,12,0,196,42524,65362.52
493512,2020,San Diego Global Knowledge University,CA,7,6,1,2,4,0,6,37686.031269160027,64276.692131199976
486965,2020,Hussian College-Los Angeles,CA,46,46,0,3,43,0,46,61271,64276.692131199976
224226,2020,Dallas Baptist University,TX,616,616,0,548,68,0,616,42855,71641.68
206349,2020,Ursuline College,OH,102,101,1,90,11,0,101,44600,60856.87
420042,2020,University of Phoenix-Hawaii,HI,1,1,0,1,0,0,1,18992,62086.89
155812,2020,University of Saint Mary,KS,196,196,0,67,129,0,196,42175,62613.14
201964,2020,Ohio Christian University,OH,140,137,3,110,27,0,137,32568,54881.86
226152,2020,Texas A & M International University,TX,1263,1249,14,1241,8,0,1249,13408,43910.56
135610,2020,Trinity International University-Florida,FL,1,1,0,1,0,0,1,37686.031269160027,72368.27
200013,2020,Rasmussen University-North Dakota,ND,45,45,0,31,14,0,45,23022,52350.64
443766,2020,Strayer University-Tennessee,TN,450,450,0,348,102,0,450,28284,64276.692131199976
433420,2020,California Aeronautical University,CA,44,44,0,44,0,0,44,42622,65732.08
230366,2020,Eagle Gate College-Murray,UT,35,35,0,34,1,0,35,22097,64280.58
202806,2020,Franklin University,OH,54,54,0,49,5,0,54,23956,59424.91
222877,2020,Arlington Baptist University,TX,54,54,0,46,8,0,54,25381,61756.37
216542,2020,University of Valley Forge,PA,100,100,0,51,49,0,100,36036,63922.06
235097,2020,Eastern Washington University,WA,1540,1525,15,1440,85,0,1525,20480,56952.77
120768,2020,Pacific Oaks College,CA,3,3,0,3,0,0,3,37686.031269160027,60596.02
474863,2020,Los Angeles Pacific University,CA,29,29,0,25,4,0,29,26995,64276.692131199976
439701,2020,The King's University,TX,19,19,0,13,6,0,19,22284,68510.99
199607,2020,Salem College,NC,121,120,1,108,12,0,120,44461,59058
171881,2020,Kuyper College,MI,24,22,2,21,1,0,22,33168,68721.86
169363,2020,Concordia University-Ann Arbor,MI,253,250,3,193,57,0,250,45348,70459.21
137564,2020,Southeastern University,FL,1267,1242,25,627,615,0,1242,39276,60101.07
215691,2020,Rosemont College,PA,112,112,0,92,20,0,112,35805,57790.62
378576,2020,Pacific College of Health and Science,CA,67,64,3,45,19,0,64,32037,64347.54
202763,2020,The University of Findlay,OH,611,609,2,480,129,0,609,47032,61890.4
204635,2020,Ohio Northern University,OH,579,576,3,473,103,0,576,49392,63536.16
458210,2020,West Coast University-Orange County,CA,16,12,4,12,0,0,12,41865,64276.692131199976
482468,2020,DeVry University-Georgia,GA,37,37,0,35,2,0,37,34215,64276.692131199976
214971,2020,Pennsylvania Academy of the Fine Arts,PA,19,18,1,8,10,0,18,62147,70798.99
181604,2020,College of Saint Mary,NE,95,94,1,66,28,0,94,31250,62625.82
177038,2020,Cleveland University-Kansas City,KS,4,4,0,2,2,0,4,37686.031269160027,61070.83
112394,2020,Cogswell University of Silicon Valley,CA,29,28,1,26,2,0,28,32382,90231.08
219718,2020,Bethel University,TN,476,471,5,399,72,0,471,30992,50031.89
456490,2020,Polytechnic University of Puerto Rico-Orlando,FL,13,13,0,13,0,0,13,22583,64276.692131199976
414878,2020,Trine University-Regional/Non-Traditional Campuses,IN,7,7,0,5,2,0,7,37686.031269160027,60275.33
198598,2020,Greensboro College,NC,133,133,0,93,40,0,133,30302,63893.94
180878,2020,Bryan College of Health Sciences,NE,63,62,1,59,3,0,62,30615,58151.07
203960,2020,Mercy College of Ohio,OH,54,54,0,40,14,0,54,22784,58075.98
157100,2020,Kentucky Christian University,KY,155,155,0,59,96,0,155,34496,53919.37
224323,2020,University of Dallas,TX,379,374,5,208,166,0,374,58050,75912.69
450571,2020,Rasmussen University-Wisconsin,WI,43,43,0,42,1,0,43,23497,64276.692131199976
160065,2020,University of Holy Cross,LA,62,52,10,51,1,0,52,23715,52742.13
210146,2020,Southern Oregon University,OR,574,532,42,314,218,0,532,17755,54749.32
240338,2020,Wisconsin Lutheran College,WI,281,281,0,186,95,0,281,43118,69126.34
444787,2020,Nightingale College,UT,118,110,8,16,94,0,110,37686.031269160027,60498.27
115773,2020,Humphreys University-Stockton and Modesto Campuses,CA,9,9,0,9,0,0,9,21249,54713.65
461032,2020,Carolina College of Biblical Studies,NC,5,5,0,5,0,0,5,21340,64276.692131199976
139579,2020,South University-Savannah,GA,14,14,0,13,1,0,14,30800,55764.27
461528,2020,Grace College of Divinity,NC,10,10,0,4,6,0,10,14977,64276.692131199976
456621,2020,Strayer University-West Virginia,WV,31,31,0,21,10,0,31,37686.031269160027,64276.692131199976
262086,2020,Brandman University,CA,101,101,0,42,59,0,101,32504,73437.32
443049,2020,Faith International University,WA,10,7,3,3,4,0,7,20830,60716.89
198756,2020,Johnson C Smith University,NC,237,237,0,103,134,0,237,33444,57295.75
137272,2020,St. John Vianney College Seminary,FL,11,11,0,9,2,0,11,40000,64276.692131199976
443784,2020,Strayer University-Pennsylvania,PA,153,153,0,135,18,0,153,28284,64276.692131199976
433004,2020,American University of Health Sciences,CA,8,8,0,8,0,0,8,35965,58092.74
447050,2020,United States University,CA,1,1,0,0,1,0,1,20187,63190.95
488448,2020,Seattle Film Institute,WA,10,10,0,9,1,0,10,46181,64276.692131199976
211468,2020,Cedar Crest College,PA,183,183,0,133,50,0,183,52279,66384.94
211431,2020,Carlow University,PA,211,209,2,191,18,0,209,44201,52873.76
490230,2020,Reformed University,GA,35,7,28,7,0,0,7,21060,64276.692131199976
205027,2020,Pontifical College Josephinum,OH,4,4,0,1,3,0,4,43542,56364.42
203474,2020,Kent State University at Trumbull,OH,281,281,0,279,2,0,281,13328,59479.84
163578,2020,Notre Dame of Maryland University,MD,71,71,0,58,13,0,71,52667,70799.46
488068,2020,Huntington University of Health Sciences,TN,4,4,0,0,4,0,4,27091,64276.692131199976
183062,2020,Keene State College,NH,737,737,0,348,389,0,737,28880,75913.18
198507,2020,Elizabeth City State University,NC,364,354,10,274,80,0,354,12754,47337.89
139153,2020,Beulah Heights University,GA,48,35,13,29,6,0,35,11650,63599.65
459994,2020,Strayer University-Global Region,DC,352,334,18,2,332,0,334,28284,64276.692131199976
386472,2020,Herzing University-Orlando,FL,77,77,0,74,3,0,77,30319,57868.59
438151,2020,Stevens-Henager College,UT,5,5,0,5,0,0,5,31726,60842.94
212984,2020,Holy Family University,PA,362,362,0,317,45,0,362,37020,61868.46
210401,2020,Willamette University,OR,324,322,2,103,219,0,322,66416,68135.42
141167,2020,Thomas University,GA,76,73,3,27,46,0,73,27354,45124.61
489779,2020,Purdue University Global,IN,1078,1069,9,93,976,0,1069,37686.031269160027,64276.692131199976
109785,2020,Azusa Pacific University,CA,624,584,40,483,101,0,584,56802,73950.46
170000,2020,Grace Christian University,MI,78,78,0,52,26,0,78,22919,62527.83
188058,2020,Northern New Mexico College,NM,98,98,0,96,2,0,98,13960,43101.41
176406,2020,Tougaloo College,MS,141,141,0,108,33,0,141,22784,44758.77
458919,2020,Strayer University-Georgia,GA,407,407,0,373,34,0,407,28284,64276.692131199976
204264,2020,Muskingum University,OH,351,350,1,287,63,0,350,41716,57566.05
181127,2020,Hastings College,NE,290,285,5,156,129,0,285,44893,58174.49
220552,2020,South College,TN,581,581,0,474,107,0,581,27758,48993.08
240392,2020,Herzing University-Madison,WI,181,181,0,44,137,0,181,29140,60281.46
446561,2020,Stanbridge University,CA,279,279,0,279,0,0,279,37686.031269160027,90341.71
457484,2020,Pacific Rim Christian University,HI,15,15,0,10,5,0,15,23131,64276.692131199976
446394,2020,Maple Springs Baptist Bible College and Seminary,MD,23,14,9,14,0,0,14,37686.031269160027,64276.692131199976
475121,2020,South University-Savannah Online,GA,244,244,0,25,219,0,244,27732,64276.692131199976
150677,2020,Grace College and Theological Seminary,IN,424,413,11,310,103,0,413,36725,63627.14
220181,2020,Fisk University,TN,251,220,31,62,158,0,220,37482,55965.03
136172,2020,University of North Florida,FL,2741,2703,38,2597,106,0,2703,19469,62628.24
211583,2020,Chestnut Hill College,PA,202,197,5,136,61,0,197,54599,61319.18
156125,2020,Wichita State University,KS,1579,1550,29,1227,323,0,1550,20418,60078.99
433536,2020,Herzing University-New Orleans,LA,41,41,0,41,0,0,41,30319,57868.59
117575,2020,Southern California Seminary,CA,4,4,0,3,1,0,4,37686.031269160027,61547.27
199971,2020,Carolina Christian College,NC,34,30,4,12,18,0,30,14600,48527.11
202073,2020,Cleveland Institute of Music,OH,54,45,9,8,37,0,45,60680,78065.66
133465,2020,South University-West Palm Beach,FL,4,4,0,4,0,0,4,28179,55764.27
251312,2020,South University-Columbia,SC,11,11,0,10,1,0,11,28397,55764.27
459842,2020,Herzing University-Kenosha,WI,54,54,0,19,35,0,54,28529,64276.692131199976
490805,2020,Purdue University Northwest,IN,1099,1099,0,950,149,0,1099,17408,64276.692131199976
229160,2020,Texas Wesleyan University,TX,243,243,0,232,11,0,243,47135,62890.39
240480,2020,University of Wisconsin-Stevens Point,WI,1838,1838,0,1664,174,0,1838,18217,62211.59
154022,2020,Ashford University,CA,623,622,1,47,575,0,622,25683,62011.29
458973,2020,Strayer University-Texas,TX,235,235,0,226,9,0,235,28284,64276.692131199976
443599,2020,American College of Healthcare Sciences,OR,35,35,0,1,34,0,35,24887,64276.692131199976
485768,2020,Atlantis University,FL,20,18,2,9,9,0,18,24942,64276.692131199976
227863,2020,University of St Thomas,TX,401,397,4,388,9,0,397,42652,71790.89
181297,2020,Nebraska Methodist College of Nursing & Allied Health,NE,50,50,0,39,11,0,50,31690,66507.51
199865,2020,Warren Wilson College,NC,194,194,0,76,118,0,194,52526,70885.71
160074,2020,Franciscan Missionaries of Our Lady University,LA,91,90,1,90,0,0,90,26751,54007.12
211477,2020,Central Penn College,PA,78,78,0,70,8,0,78,27042,56698.35
413413,2020,Capella University,MN,43,43,0,0,43,0,43,21167,64334.8
203128,2020,Hiram College,OH,232,232,0,170,62,0,232,50555,63946.73
459727,2020,Touro University Worldwide,CA,37,37,0,17,20,0,37,27335,64276.692131199976
219639,2020,Baptist Health Sciences University,TN,70,70,0,48,22,0,70,20485,61604.19
175980,2020,Millsaps College,MS,168,163,5,73,90,0,163,57996,56763.17
114123,2020,Empire College,CA,81,81,0,81,0,0,81,37686.031269160027,70826.06
159647,2020,Louisiana Tech University,LA,1863,1862,1,1850,12,0,1862,21927,46738.12
384412,2020,University of the Potomac-Washington DC Campus,DC,14,12,2,0,12,0,12,24964,78717.65
484756,2020,University of Phoenix-Texas,TX,4,4,0,4,0,0,4,16367,64276.692131199976
219709,2020,Belmont University,TN,1595,1587,8,430,1157,0,1587,54595,70368.62
203580,2020,Lake Erie College,OH,172,163,9,105,58,0,163,45740,63624.4
238193,2020,Alverno College,WI,128,128,0,110,18,0,128,40724,58784.16
219602,2020,Austin Peay State University,TN,1438,1432,6,1299,133,0,1432,23931,52472.51
200800,2020,University of Akron Main Campus,OH,2343,2316,27,2152,164,0,2316,24604,58778.75
458885,2020,Strayer University-Arkansas,AR,37,37,0,35,2,0,37,37686.031269160027,64276.692131199976
137476,2020,St. Thomas University,FL,471,449,22,411,38,0,449,46539,56846.82
216807,2020,Westminster College,PA,291,291,0,206,85,0,291,49932,56138.86
216694,2020,Waynesburg University,PA,329,327,2,243,84,0,327,37431,52961.26
457402,2020,University of Fort Lauderdale,FL,13,7,6,7,0,0,7,37686.031269160027,64276.692131199976
482608,2020,DeVry University-Pennsylvania,PA,2,2,0,2,0,0,2,34602,64276.692131199976
161873,2020,University of Baltimore,MD,74,74,0,72,2,0,74,24521,65721.01
215947,2020,Seton Hill University,PA,385,383,2,288,95,0,383,50395,54100.65
159939,2020,University of New Orleans,LA,1123,1112,11,1032,80,0,1112,20864,51940.24
461281,2020,Jose Maria Vargas University,FL,1,1,0,1,0,0,1,37686.031269160027,64276.692131199976
482459,2020,DeVry University-Florida,FL,15,15,0,15,0,0,15,37295,64276.692131199976
482574,2020,DeVry University-Ohio,OH,9,9,0,9,0,0,9,34949,64276.692131199976
217934,2020,Columbia College,SC,132,132,0,105,27,0,132,33178,56463.66
214148,2020,Moore College of Art and Design,PA,67,67,0,30,37,0,67,60910,70661.87
209409,2020,Bushnell University,OR,87,86,1,53,33,0,86,43464,52696.79
131876,2020,Trinity Washington University,DC,237,237,0,115,122,0,237,32710,60221.46
218238,2020,Limestone University,SC,324,324,0,199,125,0,324,42137,53494.1
477039,2020,West Coast University-Dallas,TX,12,12,0,9,3,0,12,27991,64276.692131199976
228981,2020,Texas Lutheran University,TX,361,361,0,357,4,0,361,42208,65468.32
173665,2020,Hamline University,MN,455,455,0,385,70,0,455,51984,70958.04
211352,2020,Cabrini University,PA,371,370,1,247,123,0,370,46293,77292.03
453163,2020,Strayer University-North Carolina,NC,301,301,0,273,28,0,301,37686.031269160027,64276.692131199976
172264,2020,Siena Heights University,MI,246,246,0,200,46,0,246,39539,63208.96
485546,2020,California Intercontinental University,CA,26,26,0,17,9,0,26,37686.031269160027,64276.692131199976
150604,2020,Franklin College,IN,293,293,0,273,20,0,293,46533,61682.88
204936,2020,Otterbein University,OH,495,495,0,440,55,0,495,45773,67882
141486,2020,Chaminade University of Honolulu,HI,276,274,2,113,161,0,274,38649,72476.63
219046,2020,Black Hills State University,SD,437,433,4,267,166,0,433,20937,49477.45
102669,2020,Alaska Pacific University,AK,24,24,0,20,4,0,24,34350,70542.98
224776,2020,Miami International University of Art & Design-Art Institute Dallas,TX,111,111,0,99,12,0,111,31913,69396.45
130989,2020,Goldey-Beacom College,DE,144,142,2,112,30,0,142,39197,70369.91
487603,2020,Northwest University-College of Adult and Professional Studies,WA,84,79,5,42,37,0,79,29793,64276.692131199976
